region	ZMAPSTYLE_MODE_BASIC	ZMAPHOMOL_NONE
sequence_secondary_structure	ZMAPSTYLE_MODE_BASIC	ZMAPHOMOL_NONE
G_quartet	ZMAPSTYLE_MODE_BASIC	ZMAPHOMOL_NONE
interior_coding_exon	ZMAPSTYLE_MODE_BASIC	ZMAPHOMOL_NONE
satellite_DNA	ZMAPSTYLE_MODE_BASIC	ZMAPHOMOL_NONE
PCR_product	ZMAPSTYLE_MODE_BASIC	ZMAPHOMOL_NONE
read_pair	ZMAPSTYLE_MODE_BASIC	ZMAPHOMOL_NONE
protein_coding	ZMAPSTYLE_MODE_BASIC	ZMAPHOMOL_NONE
non_protein_coding	ZMAPSTYLE_MODE_BASIC	ZMAPHOMOL_NONE
scRNA_primary_transcript	ZMAPSTYLE_MODE_TRANSCRIPT	ZMAPHOMOL_NONE
scRNA	ZMAPSTYLE_MODE_BASIC	ZMAPHOMOL_NONE
INR_motif	ZMAPSTYLE_MODE_BASIC	ZMAPHOMOL_NONE
DPE_motif	ZMAPSTYLE_MODE_BASIC	ZMAPHOMOL_NONE
BREu_motif	ZMAPSTYLE_MODE_BASIC	ZMAPHOMOL_NONE
PSE_motif	ZMAPSTYLE_MODE_BASIC	ZMAPHOMOL_NONE
linkage_group	ZMAPSTYLE_MODE_BASIC	ZMAPHOMOL_NONE
RNA_internal_loop	ZMAPSTYLE_MODE_BASIC	ZMAPHOMOL_NONE
asymmetric_RNA_internal_loop	ZMAPSTYLE_MODE_BASIC	ZMAPHOMOL_NONE
A_minor_RNA_motif	ZMAPSTYLE_MODE_BASIC	ZMAPHOMOL_NONE
K_turn_RNA_motif	ZMAPSTYLE_MODE_BASIC	ZMAPHOMOL_NONE
sarcin_like_RNA_motif	ZMAPSTYLE_MODE_BASIC	ZMAPHOMOL_NONE
symmetric_RNA_internal_loop	ZMAPSTYLE_MODE_BASIC	ZMAPHOMOL_NONE
RNA_junction_loop	ZMAPSTYLE_MODE_BASIC	ZMAPHOMOL_NONE
RNA_hook_turn	ZMAPSTYLE_MODE_BASIC	ZMAPHOMOL_NONE
base_pair	ZMAPSTYLE_MODE_BASIC	ZMAPHOMOL_NONE
WC_base_pair	ZMAPSTYLE_MODE_BASIC	ZMAPHOMOL_NONE
sugar_edge_base_pair	ZMAPSTYLE_MODE_BASIC	ZMAPHOMOL_NONE
aptamer	ZMAPSTYLE_MODE_BASIC	ZMAPHOMOL_NONE
DNA_aptamer	ZMAPSTYLE_MODE_BASIC	ZMAPHOMOL_NONE
RNA_aptamer	ZMAPSTYLE_MODE_BASIC	ZMAPHOMOL_NONE
morpholino_oligo	ZMAPSTYLE_MODE_BASIC	ZMAPHOMOL_NONE
riboswitch	ZMAPSTYLE_MODE_BASIC	ZMAPHOMOL_NONE
matrix_attachment_site	ZMAPSTYLE_MODE_BASIC	ZMAPHOMOL_NONE
locus_control_region	ZMAPSTYLE_MODE_BASIC	ZMAPHOMOL_NONE
match_part	ZMAPSTYLE_MODE_BASIC	ZMAPHOMOL_NONE
genomic_clone	ZMAPSTYLE_MODE_BASIC	ZMAPHOMOL_NONE
processed_pseudogene	ZMAPSTYLE_MODE_BASIC	ZMAPHOMOL_NONE
pseudogene_by_unequal_crossing_over	ZMAPSTYLE_MODE_BASIC	ZMAPHOMOL_NONE
probe	ZMAPSTYLE_MODE_BASIC	ZMAPHOMOL_NONE
aneuploid	ZMAPSTYLE_MODE_BASIC	ZMAPHOMOL_NONE
hyperploid	ZMAPSTYLE_MODE_BASIC	ZMAPHOMOL_NONE
hypoploid	ZMAPSTYLE_MODE_BASIC	ZMAPHOMOL_NONE
operator	ZMAPSTYLE_MODE_BASIC	ZMAPHOMOL_NONE
nuclease_binding_site	ZMAPSTYLE_MODE_BASIC	ZMAPHOMOL_NONE
compound_chromosome_arm	ZMAPSTYLE_MODE_BASIC	ZMAPHOMOL_NONE
restriction_enzyme_binding_site	ZMAPSTYLE_MODE_BASIC	ZMAPHOMOL_NONE
deficient_intrachromosomal_transposition	ZMAPSTYLE_MODE_BASIC	ZMAPHOMOL_NONE
deficient_interchromosomal_transposition	ZMAPSTYLE_MODE_BASIC	ZMAPHOMOL_NONE
free_chromosome_arm	ZMAPSTYLE_MODE_BASIC	ZMAPHOMOL_NONE
gene_to_gene_feature	ZMAPSTYLE_MODE_BASIC	ZMAPHOMOL_NONE
overlapping	ZMAPSTYLE_MODE_BASIC	ZMAPHOMOL_NONE
inside_intron	ZMAPSTYLE_MODE_BASIC	ZMAPHOMOL_NONE
inside_intron_antiparallel	ZMAPSTYLE_MODE_BASIC	ZMAPHOMOL_NONE
inside_intron_parallel	ZMAPSTYLE_MODE_BASIC	ZMAPHOMOL_NONE
five_prime_three_prime_overlap	ZMAPSTYLE_MODE_BASIC	ZMAPHOMOL_NONE
five_prime_five_prime_overlap	ZMAPSTYLE_MODE_BASIC	ZMAPHOMOL_NONE
three_prime_three_prime_overlap	ZMAPSTYLE_MODE_BASIC	ZMAPHOMOL_NONE
three_prime_five_prime_overlap	ZMAPSTYLE_MODE_BASIC	ZMAPHOMOL_NONE
antisense	ZMAPSTYLE_MODE_BASIC	ZMAPHOMOL_NONE
polycistronic_transcript	ZMAPSTYLE_MODE_TRANSCRIPT	ZMAPHOMOL_NONE
dicistronic_transcript	ZMAPSTYLE_MODE_TRANSCRIPT	ZMAPHOMOL_NONE
operon_member	ZMAPSTYLE_MODE_BASIC	ZMAPHOMOL_NONE
gene_array_member	ZMAPSTYLE_MODE_BASIC	ZMAPHOMOL_NONE
macronuclear_sequence	ZMAPSTYLE_MODE_BASIC	ZMAPHOMOL_NONE
micronuclear_sequence	ZMAPSTYLE_MODE_BASIC	ZMAPHOMOL_NONE
nuclear_gene	ZMAPSTYLE_MODE_BASIC	ZMAPHOMOL_NONE
mt_gene	ZMAPSTYLE_MODE_BASIC	ZMAPHOMOL_NONE
kinetoplast_gene	ZMAPSTYLE_MODE_BASIC	ZMAPHOMOL_NONE
plastid_gene	ZMAPSTYLE_MODE_BASIC	ZMAPHOMOL_NONE
apicoplast_gene	ZMAPSTYLE_MODE_BASIC	ZMAPHOMOL_NONE
ct_gene	ZMAPSTYLE_MODE_BASIC	ZMAPHOMOL_NONE
chromoplast_gene	ZMAPSTYLE_MODE_BASIC	ZMAPHOMOL_NONE
cyanelle_gene	ZMAPSTYLE_MODE_BASIC	ZMAPHOMOL_NONE
leucoplast_gene	ZMAPSTYLE_MODE_BASIC	ZMAPHOMOL_NONE
proplastid_gene	ZMAPSTYLE_MODE_BASIC	ZMAPHOMOL_NONE
nucleomorph_gene	ZMAPSTYLE_MODE_BASIC	ZMAPHOMOL_NONE
plasmid_gene	ZMAPSTYLE_MODE_BASIC	ZMAPHOMOL_NONE
proviral_gene	ZMAPSTYLE_MODE_BASIC	ZMAPHOMOL_NONE
endogenous_retroviral_gene	ZMAPSTYLE_MODE_BASIC	ZMAPHOMOL_NONE
transposable_element	ZMAPSTYLE_MODE_BASIC	ZMAPHOMOL_NONE
expressed_sequence_match	ZMAPSTYLE_MODE_ALIGNMENT	ZMAPHOMOL_NONE
clone_insert_end	ZMAPSTYLE_MODE_BASIC	ZMAPHOMOL_NONE
polypeptide	ZMAPSTYLE_MODE_BASIC	ZMAPHOMOL_NONE
chromosome_arm	ZMAPSTYLE_MODE_BASIC	ZMAPHOMOL_NONE
sequencing_primer	ZMAPSTYLE_MODE_BASIC	ZMAPHOMOL_NONE
mRNA_with_frameshift	ZMAPSTYLE_MODE_BASIC	ZMAPHOMOL_NONE
sequence_feature	ZMAPSTYLE_MODE_BASIC	ZMAPHOMOL_NONE
transposable_element_gene	ZMAPSTYLE_MODE_BASIC	ZMAPHOMOL_NONE
primer	ZMAPSTYLE_MODE_BASIC	ZMAPHOMOL_NONE
proviral_region	ZMAPSTYLE_MODE_BASIC	ZMAPHOMOL_NONE
methylated_cytosine	ZMAPSTYLE_MODE_BASIC	ZMAPHOMOL_NONE
edited	ZMAPSTYLE_MODE_BASIC	ZMAPHOMOL_NONE
transcript_with_translational_frameshift	ZMAPSTYLE_MODE_BASIC	ZMAPHOMOL_NONE
regulated	ZMAPSTYLE_MODE_BASIC	ZMAPHOMOL_NONE
protein_coding_primary_transcript	ZMAPSTYLE_MODE_TRANSCRIPT	ZMAPHOMOL_NONE
forward_primer	ZMAPSTYLE_MODE_BASIC	ZMAPHOMOL_NONE
RNA_sequence_secondary_structure	ZMAPSTYLE_MODE_BASIC	ZMAPHOMOL_NONE
transcriptionally_regulated	ZMAPSTYLE_MODE_BASIC	ZMAPHOMOL_NONE
transcriptionally_constitutive	ZMAPSTYLE_MODE_BASIC	ZMAPHOMOL_NONE
transcriptionally_induced	ZMAPSTYLE_MODE_BASIC	ZMAPHOMOL_NONE
transcriptionally_repressed	ZMAPSTYLE_MODE_BASIC	ZMAPHOMOL_NONE
silenced_gene	ZMAPSTYLE_MODE_BASIC	ZMAPHOMOL_NONE
gene_silenced_by_DNA_modification	ZMAPSTYLE_MODE_BASIC	ZMAPHOMOL_NONE
gene_silenced_by_DNA_methylation	ZMAPSTYLE_MODE_BASIC	ZMAPHOMOL_NONE
post_translationally_regulated	ZMAPSTYLE_MODE_BASIC	ZMAPHOMOL_NONE
translationally_regulated	ZMAPSTYLE_MODE_BASIC	ZMAPHOMOL_NONE
reverse_primer	ZMAPSTYLE_MODE_BASIC	ZMAPHOMOL_NONE
epigenetically_modified	ZMAPSTYLE_MODE_BASIC	ZMAPHOMOL_NONE
genomically_imprinted	ZMAPSTYLE_MODE_BASIC	ZMAPHOMOL_NONE
maternally_imprinted	ZMAPSTYLE_MODE_BASIC	ZMAPHOMOL_NONE
paternally_imprinted	ZMAPSTYLE_MODE_BASIC	ZMAPHOMOL_NONE
allelically_excluded	ZMAPSTYLE_MODE_BASIC	ZMAPHOMOL_NONE
gene_rearranged_at_DNA_level	ZMAPSTYLE_MODE_BASIC	ZMAPHOMOL_NONE
ribosome_entry_site	ZMAPSTYLE_MODE_BASIC	ZMAPHOMOL_NONE
attenuator	ZMAPSTYLE_MODE_BASIC	ZMAPHOMOL_NONE
terminator	ZMAPSTYLE_MODE_BASIC	ZMAPHOMOL_NONE
DNA_sequence_secondary_structure	ZMAPSTYLE_MODE_BASIC	ZMAPHOMOL_NONE
assembly_component	ZMAPSTYLE_MODE_BASIC	ZMAPHOMOL_NONE
recoded_codon	ZMAPSTYLE_MODE_BASIC	ZMAPHOMOL_NONE
capped	ZMAPSTYLE_MODE_BASIC	ZMAPHOMOL_NONE
exon	ZMAPSTYLE_MODE_TRANSCRIPT	ZMAPHOMOL_NONE
supercontig	ZMAPSTYLE_MODE_BASIC	ZMAPHOMOL_NONE
contig	ZMAPSTYLE_MODE_BASIC	ZMAPHOMOL_NONE
read	ZMAPSTYLE_MODE_BASIC	ZMAPHOMOL_NONE
clone	ZMAPSTYLE_MODE_BASIC	ZMAPHOMOL_NONE
YAC	ZMAPSTYLE_MODE_BASIC	ZMAPHOMOL_NONE
BAC	ZMAPSTYLE_MODE_BASIC	ZMAPHOMOL_NONE
PAC	ZMAPSTYLE_MODE_BASIC	ZMAPHOMOL_NONE
plasmid	ZMAPSTYLE_MODE_BASIC	ZMAPHOMOL_NONE
cosmid	ZMAPSTYLE_MODE_BASIC	ZMAPHOMOL_NONE
phagemid	ZMAPSTYLE_MODE_BASIC	ZMAPHOMOL_NONE
fosmid	ZMAPSTYLE_MODE_BASIC	ZMAPHOMOL_NONE
deletion	ZMAPSTYLE_MODE_BASIC	ZMAPHOMOL_NONE
methylated_adenine	ZMAPSTYLE_MODE_BASIC	ZMAPHOMOL_NONE
splice_site	ZMAPSTYLE_MODE_BASIC	ZMAPHOMOL_NONE
five_prime_cis_splice_site	ZMAPSTYLE_MODE_BASIC	ZMAPHOMOL_NONE
three_prime_cis_splice_site	ZMAPSTYLE_MODE_BASIC	ZMAPHOMOL_NONE
enhancer	ZMAPSTYLE_MODE_BASIC	ZMAPHOMOL_NONE
enhancer_bound_by_factor	ZMAPSTYLE_MODE_BASIC	ZMAPHOMOL_NONE
promoter	ZMAPSTYLE_MODE_BASIC	ZMAPHOMOL_NONE
RNApol_I_promoter	ZMAPSTYLE_MODE_BASIC	ZMAPHOMOL_NONE
RNApol_II_promoter	ZMAPSTYLE_MODE_BASIC	ZMAPHOMOL_NONE
RNApol_III_promoter	ZMAPSTYLE_MODE_BASIC	ZMAPHOMOL_NONE
CAAT_signal	ZMAPSTYLE_MODE_BASIC	ZMAPHOMOL_NONE
GC_rich_promoter_region	ZMAPSTYLE_MODE_BASIC	ZMAPHOMOL_NONE
TATA_box	ZMAPSTYLE_MODE_BASIC	ZMAPHOMOL_NONE
minus_10_signal	ZMAPSTYLE_MODE_BASIC	ZMAPHOMOL_NONE
minus_35_signal	ZMAPSTYLE_MODE_BASIC	ZMAPHOMOL_NONE
cross_genome_match	ZMAPSTYLE_MODE_ALIGNMENT	ZMAPHOMOL_NONE
operon	ZMAPSTYLE_MODE_BASIC	ZMAPHOMOL_NONE
clone_insert_start	ZMAPSTYLE_MODE_BASIC	ZMAPHOMOL_NONE
retrotransposon	ZMAPSTYLE_MODE_BASIC	ZMAPHOMOL_NONE
translated_nucleotide_match	ZMAPSTYLE_MODE_ALIGNMENT	ZMAPHOMOL_NONE
DNA_transposon	ZMAPSTYLE_MODE_BASIC	ZMAPHOMOL_NONE
non_transcribed_region	ZMAPSTYLE_MODE_BASIC	ZMAPHOMOL_NONE
U2_intron	ZMAPSTYLE_MODE_BASIC	ZMAPHOMOL_NONE
primary_transcript	ZMAPSTYLE_MODE_TRANSCRIPT	ZMAPHOMOL_NONE
LTR_retrotransposon	ZMAPSTYLE_MODE_BASIC	ZMAPHOMOL_NONE
intron	ZMAPSTYLE_MODE_TRANSCRIPT	ZMAPHOMOL_NONE
non_LTR_retrotransposon	ZMAPSTYLE_MODE_BASIC	ZMAPHOMOL_NONE
five_prime_intron	ZMAPSTYLE_MODE_BASIC	ZMAPHOMOL_NONE
interior_intron	ZMAPSTYLE_MODE_BASIC	ZMAPHOMOL_NONE
three_prime_intron	ZMAPSTYLE_MODE_BASIC	ZMAPHOMOL_NONE
RFLP_fragment	ZMAPSTYLE_MODE_BASIC	ZMAPHOMOL_NONE
LINE_element	ZMAPSTYLE_MODE_BASIC	ZMAPHOMOL_NONE
coding_exon	ZMAPSTYLE_MODE_BASIC	ZMAPHOMOL_NONE
five_prime_coding_exon_coding_region	ZMAPSTYLE_MODE_BASIC	ZMAPHOMOL_NONE
three_prime_coding_exon_coding_region	ZMAPSTYLE_MODE_BASIC	ZMAPHOMOL_NONE
noncoding_exon	ZMAPSTYLE_MODE_BASIC	ZMAPHOMOL_NONE
translocation	ZMAPSTYLE_MODE_BASIC	ZMAPHOMOL_NONE
five_prime_coding_exon	ZMAPSTYLE_MODE_BASIC	ZMAPHOMOL_NONE
interior_exon	ZMAPSTYLE_MODE_BASIC	ZMAPHOMOL_NONE
three_prime_coding_exon	ZMAPSTYLE_MODE_BASIC	ZMAPHOMOL_NONE
UTR	ZMAPSTYLE_MODE_BASIC	ZMAPHOMOL_NONE
five_prime_UTR	ZMAPSTYLE_MODE_BASIC	ZMAPHOMOL_NONE
three_prime_UTR	ZMAPSTYLE_MODE_BASIC	ZMAPHOMOL_NONE
SINE_element	ZMAPSTYLE_MODE_BASIC	ZMAPHOMOL_NONE
simple_sequence_length_variation	ZMAPSTYLE_MODE_BASIC	ZMAPHOMOL_NONE
terminal_inverted_repeat_element	ZMAPSTYLE_MODE_BASIC	ZMAPHOMOL_NONE
rRNA_primary_transcript	ZMAPSTYLE_MODE_TRANSCRIPT	ZMAPHOMOL_NONE
tRNA_primary_transcript	ZMAPSTYLE_MODE_TRANSCRIPT	ZMAPHOMOL_NONE
alanine_tRNA_primary_transcript	ZMAPSTYLE_MODE_TRANSCRIPT	ZMAPHOMOL_NONE
arginine_tRNA_primary_transcript	ZMAPSTYLE_MODE_TRANSCRIPT	ZMAPHOMOL_NONE
asparagine_tRNA_primary_transcript	ZMAPSTYLE_MODE_TRANSCRIPT	ZMAPHOMOL_NONE
aspartic_acid_tRNA_primary_transcript	ZMAPSTYLE_MODE_TRANSCRIPT	ZMAPHOMOL_NONE
cysteine_tRNA_primary_transcript	ZMAPSTYLE_MODE_TRANSCRIPT	ZMAPHOMOL_NONE
glutamic_acid_tRNA_primary_transcript	ZMAPSTYLE_MODE_TRANSCRIPT	ZMAPHOMOL_NONE
glutamine_tRNA_primary_transcript	ZMAPSTYLE_MODE_TRANSCRIPT	ZMAPHOMOL_NONE
glycine_tRNA_primary_transcript	ZMAPSTYLE_MODE_TRANSCRIPT	ZMAPHOMOL_NONE
histidine_tRNA_primary_transcript	ZMAPSTYLE_MODE_TRANSCRIPT	ZMAPHOMOL_NONE
isoleucine_tRNA_primary_transcript	ZMAPSTYLE_MODE_TRANSCRIPT	ZMAPHOMOL_NONE
leucine_tRNA_primary_transcript	ZMAPSTYLE_MODE_TRANSCRIPT	ZMAPHOMOL_NONE
lysine_tRNA_primary_transcript	ZMAPSTYLE_MODE_TRANSCRIPT	ZMAPHOMOL_NONE
methionine_tRNA_primary_transcript	ZMAPSTYLE_MODE_TRANSCRIPT	ZMAPHOMOL_NONE
phenylalanine_tRNA_primary_transcript	ZMAPSTYLE_MODE_TRANSCRIPT	ZMAPHOMOL_NONE
proline_tRNA_primary_transcript	ZMAPSTYLE_MODE_TRANSCRIPT	ZMAPHOMOL_NONE
serine_tRNA_primary_transcript	ZMAPSTYLE_MODE_TRANSCRIPT	ZMAPHOMOL_NONE
threonine_tRNA_primary_transcript	ZMAPSTYLE_MODE_TRANSCRIPT	ZMAPHOMOL_NONE
tryptophan_tRNA_primary_transcript	ZMAPSTYLE_MODE_TRANSCRIPT	ZMAPHOMOL_NONE
tyrosine_tRNA_primary_transcript	ZMAPSTYLE_MODE_TRANSCRIPT	ZMAPHOMOL_NONE
valine_tRNA_primary_transcript	ZMAPSTYLE_MODE_TRANSCRIPT	ZMAPHOMOL_NONE
snRNA_primary_transcript	ZMAPSTYLE_MODE_TRANSCRIPT	ZMAPHOMOL_NONE
snoRNA_primary_transcript	ZMAPSTYLE_MODE_TRANSCRIPT	ZMAPHOMOL_NONE
mature_transcript	ZMAPSTYLE_MODE_TRANSCRIPT	ZMAPHOMOL_NONE
mRNA	ZMAPSTYLE_MODE_BASIC	ZMAPHOMOL_NONE
TF_binding_site	ZMAPSTYLE_MODE_BASIC	ZMAPHOMOL_NONE
ORF	ZMAPSTYLE_MODE_BASIC	ZMAPHOMOL_NONE
transcript_attribute	ZMAPSTYLE_MODE_BASIC	ZMAPHOMOL_NONE
foldback_element	ZMAPSTYLE_MODE_BASIC	ZMAPHOMOL_NONE
flanking_region	ZMAPSTYLE_MODE_BASIC	ZMAPHOMOL_NONE
chromosome_variation	ZMAPSTYLE_MODE_BASIC	ZMAPHOMOL_NONE
internal_UTR	ZMAPSTYLE_MODE_BASIC	ZMAPHOMOL_NONE
untranslated_region_polycistronic_mRNA	ZMAPSTYLE_MODE_BASIC	ZMAPHOMOL_NONE
internal_ribosome_entry_site	ZMAPSTYLE_MODE_BASIC	ZMAPHOMOL_NONE
polyadenylated	ZMAPSTYLE_MODE_BASIC	ZMAPHOMOL_NONE
sequence_length_variation	ZMAPSTYLE_MODE_BASIC	ZMAPHOMOL_NONE
modified_RNA_base_feature	ZMAPSTYLE_MODE_BASIC	ZMAPHOMOL_NONE
rRNA	ZMAPSTYLE_MODE_BASIC	ZMAPHOMOL_NONE
tRNA	ZMAPSTYLE_MODE_BASIC	ZMAPHOMOL_NONE
alanyl_tRNA	ZMAPSTYLE_MODE_BASIC	ZMAPHOMOL_NONE
rRNA_small_subunit_primary_transcript	ZMAPSTYLE_MODE_TRANSCRIPT	ZMAPHOMOL_NONE
asparaginyl_tRNA	ZMAPSTYLE_MODE_BASIC	ZMAPHOMOL_NONE
aspartyl_tRNA	ZMAPSTYLE_MODE_BASIC	ZMAPHOMOL_NONE
cysteinyl_tRNA	ZMAPSTYLE_MODE_BASIC	ZMAPHOMOL_NONE
glutaminyl_tRNA	ZMAPSTYLE_MODE_BASIC	ZMAPHOMOL_NONE
glutamyl_tRNA	ZMAPSTYLE_MODE_BASIC	ZMAPHOMOL_NONE
glycyl_tRNA	ZMAPSTYLE_MODE_BASIC	ZMAPHOMOL_NONE
histidyl_tRNA	ZMAPSTYLE_MODE_BASIC	ZMAPHOMOL_NONE
isoleucyl_tRNA	ZMAPSTYLE_MODE_BASIC	ZMAPHOMOL_NONE
leucyl_tRNA	ZMAPSTYLE_MODE_BASIC	ZMAPHOMOL_NONE
lysyl_tRNA	ZMAPSTYLE_MODE_BASIC	ZMAPHOMOL_NONE
methionyl_tRNA	ZMAPSTYLE_MODE_BASIC	ZMAPHOMOL_NONE
phenylalanyl_tRNA	ZMAPSTYLE_MODE_BASIC	ZMAPHOMOL_NONE
prolyl_tRNA	ZMAPSTYLE_MODE_BASIC	ZMAPHOMOL_NONE
seryl_tRNA	ZMAPSTYLE_MODE_BASIC	ZMAPHOMOL_NONE
threonyl_tRNA	ZMAPSTYLE_MODE_BASIC	ZMAPHOMOL_NONE
tryptophanyl_tRNA	ZMAPSTYLE_MODE_BASIC	ZMAPHOMOL_NONE
tyrosyl_tRNA	ZMAPSTYLE_MODE_BASIC	ZMAPHOMOL_NONE
valyl_tRNA	ZMAPSTYLE_MODE_BASIC	ZMAPHOMOL_NONE
snRNA	ZMAPSTYLE_MODE_BASIC	ZMAPHOMOL_NONE
snoRNA	ZMAPSTYLE_MODE_BASIC	ZMAPHOMOL_NONE
miRNA	ZMAPSTYLE_MODE_BASIC	ZMAPHOMOL_NONE
bound_by_factor	ZMAPSTYLE_MODE_BASIC	ZMAPHOMOL_NONE
transcript_bound_by_nucleic_acid	ZMAPSTYLE_MODE_BASIC	ZMAPHOMOL_NONE
transcript_bound_by_protein	ZMAPSTYLE_MODE_BASIC	ZMAPHOMOL_NONE
engineered_gene	ZMAPSTYLE_MODE_BASIC	ZMAPHOMOL_NONE
engineered_foreign_gene	ZMAPSTYLE_MODE_BASIC	ZMAPHOMOL_NONE
mRNA_with_minus_1_frameshift	ZMAPSTYLE_MODE_BASIC	ZMAPHOMOL_NONE
engineered_foreign_transposable_element_gene	ZMAPSTYLE_MODE_BASIC	ZMAPHOMOL_NONE
foreign_gene	ZMAPSTYLE_MODE_BASIC	ZMAPHOMOL_NONE
long_terminal_repeat	ZMAPSTYLE_MODE_BASIC	ZMAPHOMOL_NONE
fusion_gene	ZMAPSTYLE_MODE_BASIC	ZMAPHOMOL_NONE
engineered_fusion_gene	ZMAPSTYLE_MODE_BASIC	ZMAPHOMOL_NONE
microsatellite	ZMAPSTYLE_MODE_BASIC	ZMAPHOMOL_NONE
dinucleotide_repeat_microsatellite_feature	ZMAPSTYLE_MODE_BASIC	ZMAPHOMOL_NONE
trinucleotide_repeat_microsatellite_feature	ZMAPSTYLE_MODE_BASIC	ZMAPHOMOL_NONE
engineered_foreign_repetitive_element	ZMAPSTYLE_MODE_BASIC	ZMAPHOMOL_NONE
inverted_repeat	ZMAPSTYLE_MODE_BASIC	ZMAPHOMOL_NONE
U12_intron	ZMAPSTYLE_MODE_BASIC	ZMAPHOMOL_NONE
origin_of_replication	ZMAPSTYLE_MODE_BASIC	ZMAPHOMOL_NONE
D_loop	ZMAPSTYLE_MODE_BASIC	ZMAPHOMOL_NONE
recombination_feature	ZMAPSTYLE_MODE_BASIC	ZMAPHOMOL_NONE
specific_recombination_site	ZMAPSTYLE_MODE_BASIC	ZMAPHOMOL_NONE
recombination_feature_of_rearranged_gene	ZMAPSTYLE_MODE_BASIC	ZMAPHOMOL_NONE
vertebrate_immune_system_gene_recombination_feature	ZMAPSTYLE_MODE_BASIC	ZMAPHOMOL_NONE
J_gene_recombination_feature	ZMAPSTYLE_MODE_BASIC	ZMAPHOMOL_NONE
clip	ZMAPSTYLE_MODE_BASIC	ZMAPHOMOL_NONE
modified_DNA_base	ZMAPSTYLE_MODE_BASIC	ZMAPHOMOL_NONE
methylated_DNA_base_feature	ZMAPSTYLE_MODE_BASIC	ZMAPHOMOL_NONE
CpG_island	ZMAPSTYLE_MODE_BASIC	ZMAPHOMOL_NONE
experimentally_determined	ZMAPSTYLE_MODE_BASIC	ZMAPHOMOL_NONE
stem_loop	ZMAPSTYLE_MODE_BASIC	ZMAPHOMOL_NONE
direct_repeat	ZMAPSTYLE_MODE_BASIC	ZMAPHOMOL_NONE
TSS	ZMAPSTYLE_MODE_BASIC	ZMAPHOMOL_NONE
CDS	ZMAPSTYLE_MODE_TRANSCRIPT	ZMAPHOMOL_NONE
cDNA_clone	ZMAPSTYLE_MODE_BASIC	ZMAPHOMOL_NONE
start_codon	ZMAPSTYLE_MODE_BASIC	ZMAPHOMOL_NONE
stop_codon	ZMAPSTYLE_MODE_BASIC	ZMAPHOMOL_NONE
intronic_splice_enhancer	ZMAPSTYLE_MODE_BASIC	ZMAPHOMOL_NONE
mRNA_with_plus_1_frameshift	ZMAPSTYLE_MODE_BASIC	ZMAPHOMOL_NONE
nuclease_hypersensitive_site	ZMAPSTYLE_MODE_BASIC	ZMAPHOMOL_NONE
coding_start	ZMAPSTYLE_MODE_BASIC	ZMAPHOMOL_NONE
tag	ZMAPSTYLE_MODE_BASIC	ZMAPHOMOL_NONE
rRNA_large_subunit_primary_transcript	ZMAPSTYLE_MODE_TRANSCRIPT	ZMAPHOMOL_NONE
SAGE_tag	ZMAPSTYLE_MODE_BASIC	ZMAPHOMOL_NONE
coding_end	ZMAPSTYLE_MODE_BASIC	ZMAPHOMOL_NONE
microarray_oligo	ZMAPSTYLE_MODE_BASIC	ZMAPHOMOL_NONE
mRNA_with_plus_2_frameshift	ZMAPSTYLE_MODE_BASIC	ZMAPHOMOL_NONE
conserved_region	ZMAPSTYLE_MODE_BASIC	ZMAPHOMOL_NONE
STS	ZMAPSTYLE_MODE_BASIC	ZMAPHOMOL_NONE
coding_conserved_region	ZMAPSTYLE_MODE_BASIC	ZMAPHOMOL_NONE
exon_junction	ZMAPSTYLE_MODE_BASIC	ZMAPHOMOL_NONE
nc_conserved_region	ZMAPSTYLE_MODE_BASIC	ZMAPHOMOL_NONE
mRNA_with_minus_2_frameshift	ZMAPSTYLE_MODE_BASIC	ZMAPHOMOL_NONE
pseudogene	ZMAPSTYLE_MODE_BASIC	ZMAPHOMOL_NONE
RNAi_reagent	ZMAPSTYLE_MODE_BASIC	ZMAPHOMOL_NONE
MITE	ZMAPSTYLE_MODE_BASIC	ZMAPHOMOL_NONE
recombination_hotspot	ZMAPSTYLE_MODE_BASIC	ZMAPHOMOL_NONE
chromosome	ZMAPSTYLE_MODE_BASIC	ZMAPHOMOL_NONE
chromosome_band	ZMAPSTYLE_MODE_BASIC	ZMAPHOMOL_NONE
site_specific_recombination_target_region	ZMAPSTYLE_MODE_BASIC	ZMAPHOMOL_NONE
match	ZMAPSTYLE_MODE_BASIC	ZMAPHOMOL_NONE
splice_enhancer	ZMAPSTYLE_MODE_BASIC	ZMAPHOMOL_NONE
EST	ZMAPSTYLE_MODE_BASIC	ZMAPHOMOL_NONE
loxP_site	ZMAPSTYLE_MODE_BASIC	ZMAPHOMOL_NONE
nucleotide_match	ZMAPSTYLE_MODE_ALIGNMENT	ZMAPHOMOL_NONE
nucleic_acid	ZMAPSTYLE_MODE_BASIC	ZMAPHOMOL_NONE
protein_match	ZMAPSTYLE_MODE_ALIGNMENT	ZMAPHOMOL_NONE
FRT_site	ZMAPSTYLE_MODE_BASIC	ZMAPHOMOL_NONE
synthetic_sequence	ZMAPSTYLE_MODE_BASIC	ZMAPHOMOL_NONE
DNA	ZMAPSTYLE_MODE_BASIC	ZMAPHOMOL_NONE
sequence_assembly	ZMAPSTYLE_MODE_BASIC	ZMAPHOMOL_NONE
group_1_intron_homing_endonuclease_target_region	ZMAPSTYLE_MODE_BASIC	ZMAPHOMOL_NONE
haplotype_block	ZMAPSTYLE_MODE_BASIC	ZMAPHOMOL_NONE
RNA	ZMAPSTYLE_MODE_BASIC	ZMAPHOMOL_NONE
flanked	ZMAPSTYLE_MODE_BASIC	ZMAPHOMOL_NONE
floxed	ZMAPSTYLE_MODE_BASIC	ZMAPHOMOL_NONE
codon	ZMAPSTYLE_MODE_BASIC	ZMAPHOMOL_NONE
FRT_flanked	ZMAPSTYLE_MODE_BASIC	ZMAPHOMOL_NONE
invalidated_by_chimeric_cDNA	ZMAPSTYLE_MODE_BASIC	ZMAPHOMOL_NONE
floxed_gene	ZMAPSTYLE_MODE_BASIC	ZMAPHOMOL_NONE
transposable_element_flanking_region	ZMAPSTYLE_MODE_BASIC	ZMAPHOMOL_NONE
integron	ZMAPSTYLE_MODE_BASIC	ZMAPHOMOL_NONE
insertion_site	ZMAPSTYLE_MODE_BASIC	ZMAPHOMOL_NONE
attI_site	ZMAPSTYLE_MODE_BASIC	ZMAPHOMOL_NONE
transposable_element_insertion_site	ZMAPSTYLE_MODE_BASIC	ZMAPHOMOL_NONE
small_regulatory_ncRNA	ZMAPSTYLE_MODE_BASIC	ZMAPHOMOL_NONE
conjugative_transposon	ZMAPSTYLE_MODE_BASIC	ZMAPHOMOL_NONE
enzymatic_RNA	ZMAPSTYLE_MODE_BASIC	ZMAPHOMOL_NONE
recombinationally_inverted_gene	ZMAPSTYLE_MODE_BASIC	ZMAPHOMOL_NONE
ribozyme	ZMAPSTYLE_MODE_BASIC	ZMAPHOMOL_NONE
rRNA_5_8S	ZMAPSTYLE_MODE_BASIC	ZMAPHOMOL_NONE
RNA_6S	ZMAPSTYLE_MODE_BASIC	ZMAPHOMOL_NONE
CsrB_RsmB_RNA	ZMAPSTYLE_MODE_BASIC	ZMAPHOMOL_NONE
DsrA_RNA	ZMAPSTYLE_MODE_BASIC	ZMAPHOMOL_NONE
GcvB_RNA	ZMAPSTYLE_MODE_BASIC	ZMAPHOMOL_NONE
hammerhead_ribozyme	ZMAPSTYLE_MODE_BASIC	ZMAPHOMOL_NONE
group_IIA_intron	ZMAPSTYLE_MODE_BASIC	ZMAPHOMOL_NONE
group_IIB_intron	ZMAPSTYLE_MODE_BASIC	ZMAPHOMOL_NONE
MicF_RNA	ZMAPSTYLE_MODE_BASIC	ZMAPHOMOL_NONE
OxyS_RNA	ZMAPSTYLE_MODE_BASIC	ZMAPHOMOL_NONE
RNase_MRP_RNA	ZMAPSTYLE_MODE_BASIC	ZMAPHOMOL_NONE
RNase_P_RNA	ZMAPSTYLE_MODE_BASIC	ZMAPHOMOL_NONE
RprA_RNA	ZMAPSTYLE_MODE_BASIC	ZMAPHOMOL_NONE
RRE_RNA	ZMAPSTYLE_MODE_BASIC	ZMAPHOMOL_NONE
spot_42_RNA	ZMAPSTYLE_MODE_BASIC	ZMAPHOMOL_NONE
telomerase_RNA	ZMAPSTYLE_MODE_BASIC	ZMAPHOMOL_NONE
U1_snRNA	ZMAPSTYLE_MODE_BASIC	ZMAPHOMOL_NONE
U2_snRNA	ZMAPSTYLE_MODE_BASIC	ZMAPHOMOL_NONE
U4_snRNA	ZMAPSTYLE_MODE_BASIC	ZMAPHOMOL_NONE
U4atac_snRNA	ZMAPSTYLE_MODE_BASIC	ZMAPHOMOL_NONE
U5_snRNA	ZMAPSTYLE_MODE_BASIC	ZMAPHOMOL_NONE
U6_snRNA	ZMAPSTYLE_MODE_BASIC	ZMAPHOMOL_NONE
U6atac_snRNA	ZMAPSTYLE_MODE_BASIC	ZMAPHOMOL_NONE
U11_snRNA	ZMAPSTYLE_MODE_BASIC	ZMAPHOMOL_NONE
U12_snRNA	ZMAPSTYLE_MODE_BASIC	ZMAPHOMOL_NONE
sequence_attribute	ZMAPSTYLE_MODE_BASIC	ZMAPHOMOL_NONE
gene_attribute	ZMAPSTYLE_MODE_BASIC	ZMAPHOMOL_NONE
U14_snoRNA	ZMAPSTYLE_MODE_BASIC	ZMAPHOMOL_NONE
vault_RNA	ZMAPSTYLE_MODE_BASIC	ZMAPHOMOL_NONE
Y_RNA	ZMAPSTYLE_MODE_BASIC	ZMAPHOMOL_NONE
twintron	ZMAPSTYLE_MODE_BASIC	ZMAPHOMOL_NONE
rRNA_18S	ZMAPSTYLE_MODE_BASIC	ZMAPHOMOL_NONE
binding_site	ZMAPSTYLE_MODE_BASIC	ZMAPHOMOL_NONE
protein_binding_site	ZMAPSTYLE_MODE_BASIC	ZMAPHOMOL_NONE
rescue_region	ZMAPSTYLE_MODE_BASIC	ZMAPHOMOL_NONE
restriction_fragment	ZMAPSTYLE_MODE_BASIC	ZMAPHOMOL_NONE
sequence_difference	ZMAPSTYLE_MODE_BASIC	ZMAPHOMOL_NONE
invalidated_by_genomic_contamination	ZMAPSTYLE_MODE_BASIC	ZMAPHOMOL_NONE
invalidated_by_genomic_polyA_primed_cDNA	ZMAPSTYLE_MODE_BASIC	ZMAPHOMOL_NONE
invalidated_by_partial_processing	ZMAPSTYLE_MODE_BASIC	ZMAPHOMOL_NONE
polypeptide_domain	ZMAPSTYLE_MODE_BASIC	ZMAPHOMOL_NONE
signal_peptide	ZMAPSTYLE_MODE_BASIC	ZMAPHOMOL_NONE
mature_protein_region	ZMAPSTYLE_MODE_BASIC	ZMAPHOMOL_NONE
five_prime_terminal_inverted_repeat	ZMAPSTYLE_MODE_BASIC	ZMAPHOMOL_NONE
three_prime_terminal_inverted_repeat	ZMAPSTYLE_MODE_BASIC	ZMAPHOMOL_NONE
U5_LTR_region	ZMAPSTYLE_MODE_BASIC	ZMAPHOMOL_NONE
R_LTR_region	ZMAPSTYLE_MODE_BASIC	ZMAPHOMOL_NONE
U3_LTR_region	ZMAPSTYLE_MODE_BASIC	ZMAPHOMOL_NONE
five_prime_LTR	ZMAPSTYLE_MODE_BASIC	ZMAPHOMOL_NONE
three_prime_LTR	ZMAPSTYLE_MODE_BASIC	ZMAPHOMOL_NONE
R_five_prime_LTR_region	ZMAPSTYLE_MODE_BASIC	ZMAPHOMOL_NONE
U5_five_prime_LTR_region	ZMAPSTYLE_MODE_BASIC	ZMAPHOMOL_NONE
U3_five_prime_LTR_region	ZMAPSTYLE_MODE_BASIC	ZMAPHOMOL_NONE
R_three_prime_LTR_region	ZMAPSTYLE_MODE_BASIC	ZMAPHOMOL_NONE
U3_three_prime_LTR_region	ZMAPSTYLE_MODE_BASIC	ZMAPHOMOL_NONE
U5_three_prime_LTR_region	ZMAPSTYLE_MODE_BASIC	ZMAPHOMOL_NONE
non_LTR_retrotransposon_polymeric_tract	ZMAPSTYLE_MODE_BASIC	ZMAPHOMOL_NONE
target_site_duplication	ZMAPSTYLE_MODE_BASIC	ZMAPHOMOL_NONE
RR_tract	ZMAPSTYLE_MODE_BASIC	ZMAPHOMOL_NONE
ARS	ZMAPSTYLE_MODE_BASIC	ZMAPHOMOL_NONE
inverted_ring_chromosome	ZMAPSTYLE_MODE_BASIC	ZMAPHOMOL_NONE
vector_replicon	ZMAPSTYLE_MODE_BASIC	ZMAPHOMOL_NONE
ss_oligo	ZMAPSTYLE_MODE_BASIC	ZMAPHOMOL_NONE
ds_oligo	ZMAPSTYLE_MODE_BASIC	ZMAPHOMOL_NONE
polymer_attribute	ZMAPSTYLE_MODE_BASIC	ZMAPHOMOL_NONE
three_prime_noncoding_exon	ZMAPSTYLE_MODE_BASIC	ZMAPHOMOL_NONE
five_prime_noncoding_exon	ZMAPSTYLE_MODE_BASIC	ZMAPHOMOL_NONE
UTR_intron	ZMAPSTYLE_MODE_BASIC	ZMAPHOMOL_NONE
five_prime_UTR_intron	ZMAPSTYLE_MODE_BASIC	ZMAPHOMOL_NONE
three_prime_UTR_intron	ZMAPSTYLE_MODE_BASIC	ZMAPHOMOL_NONE
random_sequence	ZMAPSTYLE_MODE_BASIC	ZMAPHOMOL_NONE
interband	ZMAPSTYLE_MODE_BASIC	ZMAPHOMOL_NONE
gene_with_polyadenylated_mRNA	ZMAPSTYLE_MODE_BASIC	ZMAPHOMOL_NONE
chromosomal_transposition	ZMAPSTYLE_MODE_BASIC	ZMAPHOMOL_NONE
rasiRNA	ZMAPSTYLE_MODE_BASIC	ZMAPHOMOL_NONE
gene_with_mRNA_with_frameshift	ZMAPSTYLE_MODE_BASIC	ZMAPHOMOL_NONE
recombinationally_rearranged_gene	ZMAPSTYLE_MODE_BASIC	ZMAPHOMOL_NONE
interchromosomal_duplication	ZMAPSTYLE_MODE_BASIC	ZMAPHOMOL_NONE
D_gene_segment	ZMAPSTYLE_MODE_BASIC	ZMAPHOMOL_NONE
gene_with_trans_spliced_transcript	ZMAPSTYLE_MODE_TRANSCRIPT	ZMAPHOMOL_NONE
vertebrate_immunoglobulin_T_cell_receptor_segment	ZMAPSTYLE_MODE_BASIC	ZMAPHOMOL_NONE
inversion_derived_bipartite_deficiency	ZMAPSTYLE_MODE_BASIC	ZMAPHOMOL_NONE
pseudogenic_region	ZMAPSTYLE_MODE_BASIC	ZMAPHOMOL_NONE
encodes_alternately_spliced_transcripts	ZMAPSTYLE_MODE_TRANSCRIPT	ZMAPHOMOL_NONE
decayed_exon	ZMAPSTYLE_MODE_BASIC	ZMAPHOMOL_NONE
inversion_derived_deficiency_plus_duplication	ZMAPSTYLE_MODE_BASIC	ZMAPHOMOL_NONE
V_gene_segment	ZMAPSTYLE_MODE_BASIC	ZMAPHOMOL_NONE
post_translationally_regulated_by_protein_stability	ZMAPSTYLE_MODE_BASIC	ZMAPHOMOL_NONE
golden_path_fragment	ZMAPSTYLE_MODE_BASIC	ZMAPHOMOL_NONE
post_translationally_regulated_by_protein_modification	ZMAPSTYLE_MODE_BASIC	ZMAPHOMOL_NONE
J_gene_segment	ZMAPSTYLE_MODE_BASIC	ZMAPHOMOL_NONE
autoregulated	ZMAPSTYLE_MODE_BASIC	ZMAPHOMOL_NONE
tiling_path	ZMAPSTYLE_MODE_BASIC	ZMAPHOMOL_NONE
negatively_autoregulated	ZMAPSTYLE_MODE_BASIC	ZMAPHOMOL_NONE
tiling_path_fragment	ZMAPSTYLE_MODE_BASIC	ZMAPHOMOL_NONE
positively_autoregulated	ZMAPSTYLE_MODE_BASIC	ZMAPHOMOL_NONE
contig_read	ZMAPSTYLE_MODE_BASIC	ZMAPHOMOL_NONE
C_gene_segment	ZMAPSTYLE_MODE_BASIC	ZMAPHOMOL_NONE
trans_spliced_transcript	ZMAPSTYLE_MODE_TRANSCRIPT	ZMAPHOMOL_NONE
tiling_path_clone	ZMAPSTYLE_MODE_BASIC	ZMAPHOMOL_NONE
terminal_inverted_repeat	ZMAPSTYLE_MODE_BASIC	ZMAPHOMOL_NONE
vertebrate_immunoglobulin_T_cell_receptor_gene_cluster	ZMAPSTYLE_MODE_BASIC	ZMAPHOMOL_NONE
nc_primary_transcript	ZMAPSTYLE_MODE_TRANSCRIPT	ZMAPHOMOL_NONE
three_prime_coding_exon_noncoding_region	ZMAPSTYLE_MODE_BASIC	ZMAPHOMOL_NONE
DJ_J_cluster	ZMAPSTYLE_MODE_BASIC	ZMAPHOMOL_NONE
five_prime_coding_exon_noncoding_region	ZMAPSTYLE_MODE_BASIC	ZMAPHOMOL_NONE
VDJ_J_C_cluster	ZMAPSTYLE_MODE_BASIC	ZMAPHOMOL_NONE
VDJ_J_cluster	ZMAPSTYLE_MODE_BASIC	ZMAPHOMOL_NONE
VJ_C_cluster	ZMAPSTYLE_MODE_BASIC	ZMAPHOMOL_NONE
VJ_J_C_cluster	ZMAPSTYLE_MODE_BASIC	ZMAPHOMOL_NONE
VJ_J_cluster	ZMAPSTYLE_MODE_BASIC	ZMAPHOMOL_NONE
D_gene_recombination_feature	ZMAPSTYLE_MODE_BASIC	ZMAPHOMOL_NONE
three_prime_D_heptamer	ZMAPSTYLE_MODE_BASIC	ZMAPHOMOL_NONE
three_prime_D_nonamer	ZMAPSTYLE_MODE_BASIC	ZMAPHOMOL_NONE
three_prime_D_spacer	ZMAPSTYLE_MODE_BASIC	ZMAPHOMOL_NONE
five_prime_D_heptamer	ZMAPSTYLE_MODE_BASIC	ZMAPHOMOL_NONE
five_prime_D_nonamer	ZMAPSTYLE_MODE_BASIC	ZMAPHOMOL_NONE
five_prime_D_spacer	ZMAPSTYLE_MODE_BASIC	ZMAPHOMOL_NONE
virtual_sequence	ZMAPSTYLE_MODE_BASIC	ZMAPHOMOL_NONE
Hoogsteen_base_pair	ZMAPSTYLE_MODE_BASIC	ZMAPHOMOL_NONE
reverse_Hoogsteen_base_pair	ZMAPSTYLE_MODE_BASIC	ZMAPHOMOL_NONE
D_DJ_C_cluster	ZMAPSTYLE_MODE_BASIC	ZMAPHOMOL_NONE
D_DJ_cluster	ZMAPSTYLE_MODE_BASIC	ZMAPHOMOL_NONE
D_DJ_J_C_cluster	ZMAPSTYLE_MODE_BASIC	ZMAPHOMOL_NONE
pseudogenic_exon	ZMAPSTYLE_MODE_BASIC	ZMAPHOMOL_NONE
D_DJ_J_cluster	ZMAPSTYLE_MODE_BASIC	ZMAPHOMOL_NONE
D_J_C_cluster	ZMAPSTYLE_MODE_BASIC	ZMAPHOMOL_NONE
VD_gene_segment	ZMAPSTYLE_MODE_BASIC	ZMAPHOMOL_NONE
J_C_cluster	ZMAPSTYLE_MODE_BASIC	ZMAPHOMOL_NONE
inversion_derived_deficiency_plus_aneuploid	ZMAPSTYLE_MODE_BASIC	ZMAPHOMOL_NONE
J_cluster	ZMAPSTYLE_MODE_BASIC	ZMAPHOMOL_NONE
J_nonamer	ZMAPSTYLE_MODE_BASIC	ZMAPHOMOL_NONE
J_heptamer	ZMAPSTYLE_MODE_BASIC	ZMAPHOMOL_NONE
pseudogenic_transcript	ZMAPSTYLE_MODE_TRANSCRIPT	ZMAPHOMOL_NONE
J_spacer	ZMAPSTYLE_MODE_BASIC	ZMAPHOMOL_NONE
V_DJ_cluster	ZMAPSTYLE_MODE_BASIC	ZMAPHOMOL_NONE
V_DJ_J_cluster	ZMAPSTYLE_MODE_BASIC	ZMAPHOMOL_NONE
V_VDJ_C_cluster	ZMAPSTYLE_MODE_BASIC	ZMAPHOMOL_NONE
V_VDJ_cluster	ZMAPSTYLE_MODE_BASIC	ZMAPHOMOL_NONE
V_VDJ_J_cluster	ZMAPSTYLE_MODE_BASIC	ZMAPHOMOL_NONE
V_VJ_C_cluster	ZMAPSTYLE_MODE_BASIC	ZMAPHOMOL_NONE
V_VJ_cluster	ZMAPSTYLE_MODE_BASIC	ZMAPHOMOL_NONE
V_VJ_J_cluster	ZMAPSTYLE_MODE_BASIC	ZMAPHOMOL_NONE
V_cluster	ZMAPSTYLE_MODE_BASIC	ZMAPHOMOL_NONE
V_D_DJ_C_cluster	ZMAPSTYLE_MODE_BASIC	ZMAPHOMOL_NONE
V_D_DJ_cluster	ZMAPSTYLE_MODE_BASIC	ZMAPHOMOL_NONE
V_D_DJ_J_C_cluster	ZMAPSTYLE_MODE_BASIC	ZMAPHOMOL_NONE
V_D_DJ_J_cluster	ZMAPSTYLE_MODE_BASIC	ZMAPHOMOL_NONE
V_D_J_C_cluster	ZMAPSTYLE_MODE_BASIC	ZMAPHOMOL_NONE
V_D_J_cluster	ZMAPSTYLE_MODE_BASIC	ZMAPHOMOL_NONE
V_heptamer	ZMAPSTYLE_MODE_BASIC	ZMAPHOMOL_NONE
V_J_cluster	ZMAPSTYLE_MODE_BASIC	ZMAPHOMOL_NONE
V_J_C_cluster	ZMAPSTYLE_MODE_BASIC	ZMAPHOMOL_NONE
V_nonamer	ZMAPSTYLE_MODE_BASIC	ZMAPHOMOL_NONE
V_spacer	ZMAPSTYLE_MODE_BASIC	ZMAPHOMOL_NONE
V_gene_recombination_feature	ZMAPSTYLE_MODE_BASIC	ZMAPHOMOL_NONE
DJ_C_cluster	ZMAPSTYLE_MODE_BASIC	ZMAPHOMOL_NONE
DJ_J_C_cluster	ZMAPSTYLE_MODE_BASIC	ZMAPHOMOL_NONE
VDJ_C_cluster	ZMAPSTYLE_MODE_BASIC	ZMAPHOMOL_NONE
V_DJ_C_cluster	ZMAPSTYLE_MODE_BASIC	ZMAPHOMOL_NONE
helitron	ZMAPSTYLE_MODE_BASIC	ZMAPHOMOL_NONE
recoding_pseudoknot	ZMAPSTYLE_MODE_BASIC	ZMAPHOMOL_NONE
designed_sequence	ZMAPSTYLE_MODE_BASIC	ZMAPHOMOL_NONE
inversion_derived_bipartite_duplication	ZMAPSTYLE_MODE_BASIC	ZMAPHOMOL_NONE
gene_with_edited_transcript	ZMAPSTYLE_MODE_TRANSCRIPT	ZMAPHOMOL_NONE
inversion_derived_duplication_plus_aneuploid	ZMAPSTYLE_MODE_BASIC	ZMAPHOMOL_NONE
aneuploid_chromosome	ZMAPSTYLE_MODE_BASIC	ZMAPHOMOL_NONE
polyA_signal_sequence	ZMAPSTYLE_MODE_BASIC	ZMAPHOMOL_NONE
Shine_Dalgarno_sequence	ZMAPSTYLE_MODE_BASIC	ZMAPHOMOL_NONE
polyA_site	ZMAPSTYLE_MODE_BASIC	ZMAPHOMOL_NONE
five_prime_clip	ZMAPSTYLE_MODE_BASIC	ZMAPHOMOL_NONE
five_prime_D_recombination_signal_sequence	ZMAPSTYLE_MODE_BASIC	ZMAPHOMOL_NONE
three_prime_clip	ZMAPSTYLE_MODE_BASIC	ZMAPHOMOL_NONE
C_cluster	ZMAPSTYLE_MODE_BASIC	ZMAPHOMOL_NONE
D_cluster	ZMAPSTYLE_MODE_BASIC	ZMAPHOMOL_NONE
D_J_cluster	ZMAPSTYLE_MODE_BASIC	ZMAPHOMOL_NONE
heptamer_of_recombination_feature_of_vertebrate_immune_system_gene	ZMAPSTYLE_MODE_BASIC	ZMAPHOMOL_NONE
nonamer_of_recombination_feature_of_vertebrate_immune_system_gene	ZMAPSTYLE_MODE_BASIC	ZMAPHOMOL_NONE
vertebrate_immune_system_gene_recombination_spacer	ZMAPSTYLE_MODE_BASIC	ZMAPHOMOL_NONE
V_DJ_J_C_cluster	ZMAPSTYLE_MODE_BASIC	ZMAPHOMOL_NONE
V_VDJ_J_C_cluster	ZMAPSTYLE_MODE_BASIC	ZMAPHOMOL_NONE
V_VJ_J_C_cluster	ZMAPSTYLE_MODE_BASIC	ZMAPHOMOL_NONE
inversion_derived_aneuploid_chromosome	ZMAPSTYLE_MODE_BASIC	ZMAPHOMOL_NONE
bidirectional_promoter	ZMAPSTYLE_MODE_BASIC	ZMAPHOMOL_NONE
retrotransposed	ZMAPSTYLE_MODE_BASIC	ZMAPHOMOL_NONE
three_prime_D_recombination_signal_sequence	ZMAPSTYLE_MODE_BASIC	ZMAPHOMOL_NONE
miRNA_encoding	ZMAPSTYLE_MODE_BASIC	ZMAPHOMOL_NONE
DJ_gene_segment	ZMAPSTYLE_MODE_BASIC	ZMAPHOMOL_NONE
rRNA_encoding	ZMAPSTYLE_MODE_BASIC	ZMAPHOMOL_NONE
VDJ_gene_segment	ZMAPSTYLE_MODE_BASIC	ZMAPHOMOL_NONE
scRNA_encoding	ZMAPSTYLE_MODE_BASIC	ZMAPHOMOL_NONE
VJ_gene_segment	ZMAPSTYLE_MODE_BASIC	ZMAPHOMOL_NONE
centromere	ZMAPSTYLE_MODE_BASIC	ZMAPHOMOL_NONE
snoRNA_encoding	ZMAPSTYLE_MODE_BASIC	ZMAPHOMOL_NONE
edited_transcript_feature	ZMAPSTYLE_MODE_TRANSCRIPT	ZMAPHOMOL_NONE
methylation_guide_snoRNA_primary_transcript	ZMAPSTYLE_MODE_TRANSCRIPT	ZMAPHOMOL_NONE
cap	ZMAPSTYLE_MODE_BASIC	ZMAPHOMOL_NONE
rRNA_cleavage_snoRNA_primary_transcript	ZMAPSTYLE_MODE_TRANSCRIPT	ZMAPHOMOL_NONE
pre_edited_region	ZMAPSTYLE_MODE_BASIC	ZMAPHOMOL_NONE
tmRNA	ZMAPSTYLE_MODE_BASIC	ZMAPHOMOL_NONE
C_D_box_snoRNA_encoding	ZMAPSTYLE_MODE_BASIC	ZMAPHOMOL_NONE
tmRNA_primary_transcript	ZMAPSTYLE_MODE_TRANSCRIPT	ZMAPHOMOL_NONE
group_I_intron	ZMAPSTYLE_MODE_BASIC	ZMAPHOMOL_NONE
autocatalytically_spliced_intron	ZMAPSTYLE_MODE_BASIC	ZMAPHOMOL_NONE
SRP_RNA_primary_transcript	ZMAPSTYLE_MODE_TRANSCRIPT	ZMAPHOMOL_NONE
SRP_RNA	ZMAPSTYLE_MODE_BASIC	ZMAPHOMOL_NONE
pseudoknot	ZMAPSTYLE_MODE_BASIC	ZMAPHOMOL_NONE
H_pseudoknot	ZMAPSTYLE_MODE_BASIC	ZMAPHOMOL_NONE
C_D_box_snoRNA	ZMAPSTYLE_MODE_BASIC	ZMAPHOMOL_NONE
H_ACA_box_snoRNA	ZMAPSTYLE_MODE_BASIC	ZMAPHOMOL_NONE
C_D_box_snoRNA_primary_transcript	ZMAPSTYLE_MODE_TRANSCRIPT	ZMAPHOMOL_NONE
H_ACA_box_snoRNA_primary_transcript	ZMAPSTYLE_MODE_TRANSCRIPT	ZMAPHOMOL_NONE
guide_RNA	ZMAPSTYLE_MODE_BASIC	ZMAPHOMOL_NONE
group_II_intron	ZMAPSTYLE_MODE_BASIC	ZMAPHOMOL_NONE
editing_block	ZMAPSTYLE_MODE_BASIC	ZMAPHOMOL_NONE
intergenic_region	ZMAPSTYLE_MODE_BASIC	ZMAPHOMOL_NONE
editing_domain	ZMAPSTYLE_MODE_BASIC	ZMAPHOMOL_NONE
unedited_region	ZMAPSTYLE_MODE_BASIC	ZMAPHOMOL_NONE
H_ACA_box_snoRNA_encoding	ZMAPSTYLE_MODE_BASIC	ZMAPHOMOL_NONE
oligo_U_tail	ZMAPSTYLE_MODE_BASIC	ZMAPHOMOL_NONE
polyA_sequence	ZMAPSTYLE_MODE_BASIC	ZMAPHOMOL_NONE
branch_site	ZMAPSTYLE_MODE_BASIC	ZMAPHOMOL_NONE
polypyrimidine_tract	ZMAPSTYLE_MODE_BASIC	ZMAPHOMOL_NONE
bacterial_RNApol_promoter	ZMAPSTYLE_MODE_BASIC	ZMAPHOMOL_NONE
bacterial_terminator	ZMAPSTYLE_MODE_BASIC	ZMAPHOMOL_NONE
terminator_of_type_2_RNApol_III_promoter	ZMAPSTYLE_MODE_BASIC	ZMAPHOMOL_NONE
transcription_end_site	ZMAPSTYLE_MODE_BASIC	ZMAPHOMOL_NONE
RNApol_III_promoter_type_1	ZMAPSTYLE_MODE_BASIC	ZMAPHOMOL_NONE
RNApol_III_promoter_type_2	ZMAPSTYLE_MODE_BASIC	ZMAPHOMOL_NONE
A_box	ZMAPSTYLE_MODE_BASIC	ZMAPHOMOL_NONE
B_box	ZMAPSTYLE_MODE_BASIC	ZMAPHOMOL_NONE
RNApol_III_promoter_type_3	ZMAPSTYLE_MODE_BASIC	ZMAPHOMOL_NONE
C_box	ZMAPSTYLE_MODE_BASIC	ZMAPHOMOL_NONE
snRNA_encoding	ZMAPSTYLE_MODE_BASIC	ZMAPHOMOL_NONE
telomere	ZMAPSTYLE_MODE_BASIC	ZMAPHOMOL_NONE
silencer	ZMAPSTYLE_MODE_BASIC	ZMAPHOMOL_NONE
chromosomal_regulatory_element	ZMAPSTYLE_MODE_BASIC	ZMAPHOMOL_NONE
insulator	ZMAPSTYLE_MODE_BASIC	ZMAPHOMOL_NONE
chromosomal_structural_element	ZMAPSTYLE_MODE_BASIC	ZMAPHOMOL_NONE
five_prime_open_reading_frame	ZMAPSTYLE_MODE_BASIC	ZMAPHOMOL_NONE
upstream_AUG_codon	ZMAPSTYLE_MODE_BASIC	ZMAPHOMOL_NONE
polycistronic_primary_transcript	ZMAPSTYLE_MODE_TRANSCRIPT	ZMAPHOMOL_NONE
monocistronic_primary_transcript	ZMAPSTYLE_MODE_TRANSCRIPT	ZMAPHOMOL_NONE
monocistronic_mRNA	ZMAPSTYLE_MODE_BASIC	ZMAPHOMOL_NONE
polycistronic_mRNA	ZMAPSTYLE_MODE_BASIC	ZMAPHOMOL_NONE
mini_exon_donor_RNA	ZMAPSTYLE_MODE_BASIC	ZMAPHOMOL_NONE
spliced_leader_RNA	ZMAPSTYLE_MODE_BASIC	ZMAPHOMOL_NONE
engineered_plasmid	ZMAPSTYLE_MODE_BASIC	ZMAPHOMOL_NONE
transcribed_spacer_region	ZMAPSTYLE_MODE_BASIC	ZMAPHOMOL_NONE
internal_transcribed_spacer_region	ZMAPSTYLE_MODE_BASIC	ZMAPHOMOL_NONE
external_transcribed_spacer_region	ZMAPSTYLE_MODE_BASIC	ZMAPHOMOL_NONE
tetranucleotide_repeat_microsatellite_feature	ZMAPSTYLE_MODE_BASIC	ZMAPHOMOL_NONE
SRP_RNA_encoding	ZMAPSTYLE_MODE_BASIC	ZMAPHOMOL_NONE
minisatellite	ZMAPSTYLE_MODE_BASIC	ZMAPHOMOL_NONE
antisense_RNA	ZMAPSTYLE_MODE_BASIC	ZMAPHOMOL_NONE
antisense_primary_transcript	ZMAPSTYLE_MODE_TRANSCRIPT	ZMAPHOMOL_NONE
siRNA	ZMAPSTYLE_MODE_BASIC	ZMAPHOMOL_NONE
miRNA_primary_transcript	ZMAPSTYLE_MODE_TRANSCRIPT	ZMAPHOMOL_NONE
stRNA_primary_transcript	ZMAPSTYLE_MODE_TRANSCRIPT	ZMAPHOMOL_NONE
stRNA	ZMAPSTYLE_MODE_BASIC	ZMAPHOMOL_NONE
small_subunit_rRNA	ZMAPSTYLE_MODE_BASIC	ZMAPHOMOL_NONE
large_subunit_rRNA	ZMAPSTYLE_MODE_BASIC	ZMAPHOMOL_NONE
rRNA_5S	ZMAPSTYLE_MODE_BASIC	ZMAPHOMOL_NONE
rRNA_28S	ZMAPSTYLE_MODE_BASIC	ZMAPHOMOL_NONE
maxicircle_gene	ZMAPSTYLE_MODE_BASIC	ZMAPHOMOL_NONE
ncRNA	ZMAPSTYLE_MODE_BASIC	ZMAPHOMOL_NONE
stRNA_encoding	ZMAPSTYLE_MODE_BASIC	ZMAPHOMOL_NONE
repeat_region	ZMAPSTYLE_MODE_BASIC	ZMAPHOMOL_NONE
dispersed_repeat	ZMAPSTYLE_MODE_BASIC	ZMAPHOMOL_NONE
tmRNA_encoding	ZMAPSTYLE_MODE_BASIC	ZMAPHOMOL_NONE
spliceosomal_intron	ZMAPSTYLE_MODE_BASIC	ZMAPHOMOL_NONE
tRNA_encoding	ZMAPSTYLE_MODE_BASIC	ZMAPHOMOL_NONE
introgressed_chromosome_region	ZMAPSTYLE_MODE_BASIC	ZMAPHOMOL_NONE
monocistronic_transcript	ZMAPSTYLE_MODE_TRANSCRIPT	ZMAPHOMOL_NONE
mobile_intron	ZMAPSTYLE_MODE_BASIC	ZMAPHOMOL_NONE
insertion	ZMAPSTYLE_MODE_BASIC	ZMAPHOMOL_NONE
EST_match	ZMAPSTYLE_MODE_ALIGNMENT	ZMAPHOMOL_NONE
sequence_rearrangement_feature	ZMAPSTYLE_MODE_BASIC	ZMAPHOMOL_NONE
chromosome_breakage_sequence	ZMAPSTYLE_MODE_BASIC	ZMAPHOMOL_NONE
internal_eliminated_sequence	ZMAPSTYLE_MODE_BASIC	ZMAPHOMOL_NONE
macronucleus_destined_segment	ZMAPSTYLE_MODE_BASIC	ZMAPHOMOL_NONE
transcript	ZMAPSTYLE_MODE_BASIC	ZMAPHOMOL_NONE
canonical_three_prime_splice_site	ZMAPSTYLE_MODE_BASIC	ZMAPHOMOL_NONE
canonical_five_prime_splice_site	ZMAPSTYLE_MODE_BASIC	ZMAPHOMOL_NONE
non_canonical_three_prime_splice_site	ZMAPSTYLE_MODE_BASIC	ZMAPHOMOL_NONE
non_canonical_five_prime_splice_site	ZMAPSTYLE_MODE_BASIC	ZMAPHOMOL_NONE
non_canonical_start_codon	ZMAPSTYLE_MODE_BASIC	ZMAPHOMOL_NONE
aberrant_processed_transcript	ZMAPSTYLE_MODE_TRANSCRIPT	ZMAPHOMOL_NONE
exonic_splice_enhancer	ZMAPSTYLE_MODE_BASIC	ZMAPHOMOL_NONE
nuclease_sensitive_site	ZMAPSTYLE_MODE_BASIC	ZMAPHOMOL_NONE
DNAseI_hypersensitive_site	ZMAPSTYLE_MODE_BASIC	ZMAPHOMOL_NONE
translocation_element	ZMAPSTYLE_MODE_BASIC	ZMAPHOMOL_NONE
deletion_junction	ZMAPSTYLE_MODE_BASIC	ZMAPHOMOL_NONE
golden_path	ZMAPSTYLE_MODE_BASIC	ZMAPHOMOL_NONE
cDNA_match	ZMAPSTYLE_MODE_ALIGNMENT	ZMAPHOMOL_NONE
gene_with_polycistronic_transcript	ZMAPSTYLE_MODE_TRANSCRIPT	ZMAPHOMOL_NONE
cleaved_initiator_methionine	ZMAPSTYLE_MODE_BASIC	ZMAPHOMOL_NONE
gene_with_dicistronic_transcript	ZMAPSTYLE_MODE_TRANSCRIPT	ZMAPHOMOL_NONE
gene_with_recoded_mRNA	ZMAPSTYLE_MODE_BASIC	ZMAPHOMOL_NONE
SNP	ZMAPSTYLE_MODE_BASIC	ZMAPHOMOL_NONE
reagent	ZMAPSTYLE_MODE_BASIC	ZMAPHOMOL_NONE
oligo	ZMAPSTYLE_MODE_BASIC	ZMAPHOMOL_NONE
gene_with_stop_codon_read_through	ZMAPSTYLE_MODE_BASIC	ZMAPHOMOL_NONE
gene_with_stop_codon_redefined_as_pyrrolysine	ZMAPSTYLE_MODE_BASIC	ZMAPHOMOL_NONE
junction	ZMAPSTYLE_MODE_BASIC	ZMAPHOMOL_NONE
remark	ZMAPSTYLE_MODE_BASIC	ZMAPHOMOL_NONE
possible_base_call_error	ZMAPSTYLE_MODE_BASIC	ZMAPHOMOL_NONE
possible_assembly_error	ZMAPSTYLE_MODE_BASIC	ZMAPHOMOL_NONE
experimental_result_region	ZMAPSTYLE_MODE_BASIC	ZMAPHOMOL_NONE
gene	ZMAPSTYLE_MODE_BASIC	ZMAPHOMOL_NONE
tandem_repeat	ZMAPSTYLE_MODE_BASIC	ZMAPHOMOL_NONE
trans_splice_acceptor_site	ZMAPSTYLE_MODE_BASIC	ZMAPHOMOL_NONE
trans_splice_donor_site	ZMAPSTYLE_MODE_BASIC	ZMAPHOMOL_NONE
SL1_acceptor_site	ZMAPSTYLE_MODE_BASIC	ZMAPHOMOL_NONE
SL2_acceptor_site	ZMAPSTYLE_MODE_BASIC	ZMAPHOMOL_NONE
gene_with_stop_codon_redefined_as_selenocysteine	ZMAPSTYLE_MODE_BASIC	ZMAPHOMOL_NONE
gene_with_mRNA_recoded_by_translational_bypass	ZMAPSTYLE_MODE_BASIC	ZMAPHOMOL_NONE
gene_with_transcript_with_translational_frameshift	ZMAPSTYLE_MODE_TRANSCRIPT	ZMAPHOMOL_NONE
DNA_motif	ZMAPSTYLE_MODE_BASIC	ZMAPHOMOL_NONE
nucleotide_motif	ZMAPSTYLE_MODE_ALIGNMENT	ZMAPHOMOL_NONE
RNA_motif	ZMAPSTYLE_MODE_BASIC	ZMAPHOMOL_NONE
dicistronic_mRNA	ZMAPSTYLE_MODE_BASIC	ZMAPHOMOL_NONE
reading_frame	ZMAPSTYLE_MODE_BASIC	ZMAPHOMOL_NONE
blocked_reading_frame	ZMAPSTYLE_MODE_BASIC	ZMAPHOMOL_NONE
ultracontig	ZMAPSTYLE_MODE_BASIC	ZMAPHOMOL_NONE
foreign_transposable_element	ZMAPSTYLE_MODE_BASIC	ZMAPHOMOL_NONE
gene_with_dicistronic_primary_transcript	ZMAPSTYLE_MODE_TRANSCRIPT	ZMAPHOMOL_NONE
gene_with_dicistronic_mRNA	ZMAPSTYLE_MODE_BASIC	ZMAPHOMOL_NONE
iDNA	ZMAPSTYLE_MODE_BASIC	ZMAPHOMOL_NONE
oriT	ZMAPSTYLE_MODE_BASIC	ZMAPHOMOL_NONE
transit_peptide	ZMAPSTYLE_MODE_BASIC	ZMAPHOMOL_NONE
repeat_unit	ZMAPSTYLE_MODE_BASIC	ZMAPHOMOL_NONE
CRM	ZMAPSTYLE_MODE_BASIC	ZMAPHOMOL_NONE
intein	ZMAPSTYLE_MODE_BASIC	ZMAPHOMOL_NONE
intein_containing	ZMAPSTYLE_MODE_BASIC	ZMAPHOMOL_NONE
gap	ZMAPSTYLE_MODE_BASIC	ZMAPHOMOL_NONE
fragmentary	ZMAPSTYLE_MODE_BASIC	ZMAPHOMOL_NONE
predicted	ZMAPSTYLE_MODE_BASIC	ZMAPHOMOL_NONE
feature_attribute	ZMAPSTYLE_MODE_BASIC	ZMAPHOMOL_NONE
exemplar_mRNA	ZMAPSTYLE_MODE_BASIC	ZMAPHOMOL_NONE
sequence_location	ZMAPSTYLE_MODE_BASIC	ZMAPHOMOL_NONE
organelle_sequence	ZMAPSTYLE_MODE_BASIC	ZMAPHOMOL_NONE
mitochondrial_sequence	ZMAPSTYLE_MODE_BASIC	ZMAPHOMOL_NONE
nuclear_sequence	ZMAPSTYLE_MODE_BASIC	ZMAPHOMOL_NONE
nucleomorphic_sequence	ZMAPSTYLE_MODE_BASIC	ZMAPHOMOL_NONE
plastid_sequence	ZMAPSTYLE_MODE_BASIC	ZMAPHOMOL_NONE
kinetoplast	ZMAPSTYLE_MODE_BASIC	ZMAPHOMOL_NONE
maxicircle	ZMAPSTYLE_MODE_BASIC	ZMAPHOMOL_NONE
apicoplast_sequence	ZMAPSTYLE_MODE_BASIC	ZMAPHOMOL_NONE
chromoplast_sequence	ZMAPSTYLE_MODE_BASIC	ZMAPHOMOL_NONE
chloroplast_sequence	ZMAPSTYLE_MODE_BASIC	ZMAPHOMOL_NONE
cyanelle_sequence	ZMAPSTYLE_MODE_BASIC	ZMAPHOMOL_NONE
leucoplast_sequence	ZMAPSTYLE_MODE_BASIC	ZMAPHOMOL_NONE
proplastid_sequence	ZMAPSTYLE_MODE_BASIC	ZMAPHOMOL_NONE
plasmid_location	ZMAPSTYLE_MODE_BASIC	ZMAPHOMOL_NONE
amplification_origin	ZMAPSTYLE_MODE_BASIC	ZMAPHOMOL_NONE
proviral_location	ZMAPSTYLE_MODE_BASIC	ZMAPHOMOL_NONE
gene_group_regulatory_region	ZMAPSTYLE_MODE_BASIC	ZMAPHOMOL_NONE
clone_insert	ZMAPSTYLE_MODE_BASIC	ZMAPHOMOL_NONE
lambda_vector	ZMAPSTYLE_MODE_BASIC	ZMAPHOMOL_NONE
plasmid_vector	ZMAPSTYLE_MODE_BASIC	ZMAPHOMOL_NONE
cDNA	ZMAPSTYLE_MODE_BASIC	ZMAPHOMOL_NONE
single_stranded_cDNA	ZMAPSTYLE_MODE_BASIC	ZMAPHOMOL_NONE
double_stranded_cDNA	ZMAPSTYLE_MODE_BASIC	ZMAPHOMOL_NONE
pyrrolysyl_tRNA	ZMAPSTYLE_MODE_BASIC	ZMAPHOMOL_NONE
episome	ZMAPSTYLE_MODE_BASIC	ZMAPHOMOL_NONE
tmRNA_coding_piece	ZMAPSTYLE_MODE_BASIC	ZMAPHOMOL_NONE
tmRNA_acceptor_piece	ZMAPSTYLE_MODE_BASIC	ZMAPHOMOL_NONE
QTL	ZMAPSTYLE_MODE_BASIC	ZMAPHOMOL_NONE
genomic_island	ZMAPSTYLE_MODE_BASIC	ZMAPHOMOL_NONE
pathogenic_island	ZMAPSTYLE_MODE_BASIC	ZMAPHOMOL_NONE
metabolic_island	ZMAPSTYLE_MODE_BASIC	ZMAPHOMOL_NONE
adaptive_island	ZMAPSTYLE_MODE_BASIC	ZMAPHOMOL_NONE
symbiosis_island	ZMAPSTYLE_MODE_BASIC	ZMAPHOMOL_NONE
pseudogenic_rRNA	ZMAPSTYLE_MODE_BASIC	ZMAPHOMOL_NONE
pseudogenic_tRNA	ZMAPSTYLE_MODE_BASIC	ZMAPHOMOL_NONE
engineered_episome	ZMAPSTYLE_MODE_BASIC	ZMAPHOMOL_NONE
transgenic	ZMAPSTYLE_MODE_BASIC	ZMAPHOMOL_NONE
natural	ZMAPSTYLE_MODE_BASIC	ZMAPHOMOL_NONE
engineered	ZMAPSTYLE_MODE_BASIC	ZMAPHOMOL_NONE
foreign	ZMAPSTYLE_MODE_BASIC	ZMAPHOMOL_NONE
cloned_region	ZMAPSTYLE_MODE_BASIC	ZMAPHOMOL_NONE
validated	ZMAPSTYLE_MODE_BASIC	ZMAPHOMOL_NONE
invalidated	ZMAPSTYLE_MODE_BASIC	ZMAPHOMOL_NONE
engineered_rescue_region	ZMAPSTYLE_MODE_BASIC	ZMAPHOMOL_NONE
rescue_mini_gene	ZMAPSTYLE_MODE_BASIC	ZMAPHOMOL_NONE
transgenic_transposable_element	ZMAPSTYLE_MODE_BASIC	ZMAPHOMOL_NONE
natural_transposable_element	ZMAPSTYLE_MODE_BASIC	ZMAPHOMOL_NONE
engineered_transposable_element	ZMAPSTYLE_MODE_BASIC	ZMAPHOMOL_NONE
engineered_foreign_transposable_element	ZMAPSTYLE_MODE_BASIC	ZMAPHOMOL_NONE
assortment_derived_duplication	ZMAPSTYLE_MODE_BASIC	ZMAPHOMOL_NONE
assortment_derived_deficiency_plus_duplication	ZMAPSTYLE_MODE_BASIC	ZMAPHOMOL_NONE
assortment_derived_deficiency	ZMAPSTYLE_MODE_BASIC	ZMAPHOMOL_NONE
assortment_derived_aneuploid	ZMAPSTYLE_MODE_BASIC	ZMAPHOMOL_NONE
engineered_region	ZMAPSTYLE_MODE_BASIC	ZMAPHOMOL_NONE
engineered_foreign_region	ZMAPSTYLE_MODE_BASIC	ZMAPHOMOL_NONE
fusion	ZMAPSTYLE_MODE_BASIC	ZMAPHOMOL_NONE
engineered_tag	ZMAPSTYLE_MODE_BASIC	ZMAPHOMOL_NONE
validated_cDNA_clone	ZMAPSTYLE_MODE_BASIC	ZMAPHOMOL_NONE
invalidated_cDNA_clone	ZMAPSTYLE_MODE_BASIC	ZMAPHOMOL_NONE
chimeric_cDNA_clone	ZMAPSTYLE_MODE_BASIC	ZMAPHOMOL_NONE
genomically_contaminated_cDNA_clone	ZMAPSTYLE_MODE_BASIC	ZMAPHOMOL_NONE
polyA_primed_cDNA_clone	ZMAPSTYLE_MODE_BASIC	ZMAPHOMOL_NONE
partially_processed_cDNA_clone	ZMAPSTYLE_MODE_BASIC	ZMAPHOMOL_NONE
rescue	ZMAPSTYLE_MODE_BASIC	ZMAPHOMOL_NONE
mini_gene	ZMAPSTYLE_MODE_BASIC	ZMAPHOMOL_NONE
rescue_gene	ZMAPSTYLE_MODE_BASIC	ZMAPHOMOL_NONE
wild_type	ZMAPSTYLE_MODE_BASIC	ZMAPHOMOL_NONE
wild_type_rescue_gene	ZMAPSTYLE_MODE_BASIC	ZMAPHOMOL_NONE
mitochondrial_chromosome	ZMAPSTYLE_MODE_BASIC	ZMAPHOMOL_NONE
chloroplast_chromosome	ZMAPSTYLE_MODE_BASIC	ZMAPHOMOL_NONE
chromoplast_chromosome	ZMAPSTYLE_MODE_BASIC	ZMAPHOMOL_NONE
cyanelle_chromosome	ZMAPSTYLE_MODE_BASIC	ZMAPHOMOL_NONE
leucoplast_chromosome	ZMAPSTYLE_MODE_BASIC	ZMAPHOMOL_NONE
macronuclear_chromosome	ZMAPSTYLE_MODE_BASIC	ZMAPHOMOL_NONE
micronuclear_chromosome	ZMAPSTYLE_MODE_BASIC	ZMAPHOMOL_NONE
nuclear_chromosome	ZMAPSTYLE_MODE_BASIC	ZMAPHOMOL_NONE
nucleomorphic_chromosome	ZMAPSTYLE_MODE_BASIC	ZMAPHOMOL_NONE
chromosome_part	ZMAPSTYLE_MODE_BASIC	ZMAPHOMOL_NONE
gene_member_region	ZMAPSTYLE_MODE_BASIC	ZMAPHOMOL_NONE
transcript_region	ZMAPSTYLE_MODE_BASIC	ZMAPHOMOL_NONE
mature_transcript_region	ZMAPSTYLE_MODE_TRANSCRIPT	ZMAPHOMOL_NONE
primary_transcript_region	ZMAPSTYLE_MODE_TRANSCRIPT	ZMAPHOMOL_NONE
mRNA_region	ZMAPSTYLE_MODE_BASIC	ZMAPHOMOL_NONE
UTR_region	ZMAPSTYLE_MODE_BASIC	ZMAPHOMOL_NONE
rRNA_primary_transcript_region	ZMAPSTYLE_MODE_TRANSCRIPT	ZMAPHOMOL_NONE
polypeptide_region	ZMAPSTYLE_MODE_BASIC	ZMAPHOMOL_NONE
repeat_component	ZMAPSTYLE_MODE_BASIC	ZMAPHOMOL_NONE
spliceosomal_intron_region	ZMAPSTYLE_MODE_BASIC	ZMAPHOMOL_NONE
gene_component_region	ZMAPSTYLE_MODE_BASIC	ZMAPHOMOL_NONE
tmRNA_region	ZMAPSTYLE_MODE_BASIC	ZMAPHOMOL_NONE
LTR_component	ZMAPSTYLE_MODE_BASIC	ZMAPHOMOL_NONE
three_prime_LTR_component	ZMAPSTYLE_MODE_BASIC	ZMAPHOMOL_NONE
five_prime_LTR_component	ZMAPSTYLE_MODE_BASIC	ZMAPHOMOL_NONE
CDS_region	ZMAPSTYLE_MODE_BASIC	ZMAPHOMOL_NONE
exon_region	ZMAPSTYLE_MODE_BASIC	ZMAPHOMOL_NONE
homologous_region	ZMAPSTYLE_MODE_BASIC	ZMAPHOMOL_NONE
paralogous_region	ZMAPSTYLE_MODE_BASIC	ZMAPHOMOL_NONE
orthologous_region	ZMAPSTYLE_MODE_BASIC	ZMAPHOMOL_NONE
conserved	ZMAPSTYLE_MODE_BASIC	ZMAPHOMOL_NONE
homologous	ZMAPSTYLE_MODE_BASIC	ZMAPHOMOL_NONE
orthologous	ZMAPSTYLE_MODE_BASIC	ZMAPHOMOL_NONE
paralogous	ZMAPSTYLE_MODE_BASIC	ZMAPHOMOL_NONE
syntenic	ZMAPSTYLE_MODE_BASIC	ZMAPHOMOL_NONE
capped_primary_transcript	ZMAPSTYLE_MODE_TRANSCRIPT	ZMAPHOMOL_NONE
capped_mRNA	ZMAPSTYLE_MODE_BASIC	ZMAPHOMOL_NONE
mRNA_attribute	ZMAPSTYLE_MODE_BASIC	ZMAPHOMOL_NONE
exemplar	ZMAPSTYLE_MODE_BASIC	ZMAPHOMOL_NONE
frameshift	ZMAPSTYLE_MODE_BASIC	ZMAPHOMOL_NONE
minus_1_frameshift	ZMAPSTYLE_MODE_BASIC	ZMAPHOMOL_NONE
minus_2_frameshift	ZMAPSTYLE_MODE_BASIC	ZMAPHOMOL_NONE
plus_1_frameshift	ZMAPSTYLE_MODE_BASIC	ZMAPHOMOL_NONE
plus_2_framshift	ZMAPSTYLE_MODE_BASIC	ZMAPHOMOL_NONE
trans_spliced	ZMAPSTYLE_MODE_BASIC	ZMAPHOMOL_NONE
polyadenylated_mRNA	ZMAPSTYLE_MODE_BASIC	ZMAPHOMOL_NONE
trans_spliced_mRNA	ZMAPSTYLE_MODE_BASIC	ZMAPHOMOL_NONE
edited_transcript	ZMAPSTYLE_MODE_TRANSCRIPT	ZMAPHOMOL_NONE
edited_transcript_by_A_to_I_substitution	ZMAPSTYLE_MODE_TRANSCRIPT	ZMAPHOMOL_NONE
bound_by_protein	ZMAPSTYLE_MODE_BASIC	ZMAPHOMOL_NONE
bound_by_nucleic_acid	ZMAPSTYLE_MODE_BASIC	ZMAPHOMOL_NONE
alternatively_spliced	ZMAPSTYLE_MODE_BASIC	ZMAPHOMOL_NONE
monocistronic	ZMAPSTYLE_MODE_BASIC	ZMAPHOMOL_NONE
dicistronic	ZMAPSTYLE_MODE_BASIC	ZMAPHOMOL_NONE
polycistronic	ZMAPSTYLE_MODE_BASIC	ZMAPHOMOL_NONE
recoded	ZMAPSTYLE_MODE_BASIC	ZMAPHOMOL_NONE
codon_redefined	ZMAPSTYLE_MODE_BASIC	ZMAPHOMOL_NONE
stop_codon_read_through	ZMAPSTYLE_MODE_BASIC	ZMAPHOMOL_NONE
stop_codon_redefined_as_pyrrolysine	ZMAPSTYLE_MODE_BASIC	ZMAPHOMOL_NONE
stop_codon_redefined_as_selenocysteine	ZMAPSTYLE_MODE_BASIC	ZMAPHOMOL_NONE
recoded_by_translational_bypass	ZMAPSTYLE_MODE_BASIC	ZMAPHOMOL_NONE
translationally_frameshifted	ZMAPSTYLE_MODE_BASIC	ZMAPHOMOL_NONE
maternally_imprinted_gene	ZMAPSTYLE_MODE_BASIC	ZMAPHOMOL_NONE
paternally_imprinted_gene	ZMAPSTYLE_MODE_BASIC	ZMAPHOMOL_NONE
post_translationally_regulated_gene	ZMAPSTYLE_MODE_BASIC	ZMAPHOMOL_NONE
negatively_autoregulated_gene	ZMAPSTYLE_MODE_BASIC	ZMAPHOMOL_NONE
positively_autoregulated_gene	ZMAPSTYLE_MODE_BASIC	ZMAPHOMOL_NONE
silenced	ZMAPSTYLE_MODE_BASIC	ZMAPHOMOL_NONE
silenced_by_DNA_modification	ZMAPSTYLE_MODE_BASIC	ZMAPHOMOL_NONE
silenced_by_DNA_methylation	ZMAPSTYLE_MODE_BASIC	ZMAPHOMOL_NONE
translationally_regulated_gene	ZMAPSTYLE_MODE_BASIC	ZMAPHOMOL_NONE
allelically_excluded_gene	ZMAPSTYLE_MODE_BASIC	ZMAPHOMOL_NONE
epigenetically_modified_gene	ZMAPSTYLE_MODE_BASIC	ZMAPHOMOL_NONE
transgene	ZMAPSTYLE_MODE_BASIC	ZMAPHOMOL_NONE
endogenous_retroviral_sequence	ZMAPSTYLE_MODE_BASIC	ZMAPHOMOL_NONE
rearranged_at_DNA_level	ZMAPSTYLE_MODE_BASIC	ZMAPHOMOL_NONE
status	ZMAPSTYLE_MODE_BASIC	ZMAPHOMOL_NONE
independently_known	ZMAPSTYLE_MODE_BASIC	ZMAPHOMOL_NONE
supported_by_sequence_similarity	ZMAPSTYLE_MODE_BASIC	ZMAPHOMOL_NONE
supported_by_domain_match	ZMAPSTYLE_MODE_ALIGNMENT	ZMAPHOMOL_NONE
supported_by_EST_or_cDNA	ZMAPSTYLE_MODE_BASIC	ZMAPHOMOL_NONE
orphan	ZMAPSTYLE_MODE_BASIC	ZMAPHOMOL_NONE
predicted_by_ab_initio_computation	ZMAPSTYLE_MODE_BASIC	ZMAPHOMOL_NONE
asx_turn	ZMAPSTYLE_MODE_BASIC	ZMAPHOMOL_NONE
cloned_cDNA_insert	ZMAPSTYLE_MODE_BASIC	ZMAPHOMOL_NONE
cloned_genomic_insert	ZMAPSTYLE_MODE_BASIC	ZMAPHOMOL_NONE
engineered_insert	ZMAPSTYLE_MODE_BASIC	ZMAPHOMOL_NONE
edited_mRNA	ZMAPSTYLE_MODE_BASIC	ZMAPHOMOL_NONE
guide_RNA_region	ZMAPSTYLE_MODE_BASIC	ZMAPHOMOL_NONE
anchor_region	ZMAPSTYLE_MODE_BASIC	ZMAPHOMOL_NONE
pre_edited_mRNA	ZMAPSTYLE_MODE_BASIC	ZMAPHOMOL_NONE
intermediate	ZMAPSTYLE_MODE_BASIC	ZMAPHOMOL_NONE
miRNA_target_site	ZMAPSTYLE_MODE_BASIC	ZMAPHOMOL_NONE
edited_CDS	ZMAPSTYLE_MODE_BASIC	ZMAPHOMOL_NONE
vertebrate_immunoglobulin_T_cell_receptor_rearranged_segment	ZMAPSTYLE_MODE_BASIC	ZMAPHOMOL_NONE
vertebrate_immunoglobulin_T_cell_receptor_rearranged_gene_cluster	ZMAPSTYLE_MODE_BASIC	ZMAPHOMOL_NONE
vertebrate_immune_system_gene_recombination_signal_feature	ZMAPSTYLE_MODE_BASIC	ZMAPHOMOL_NONE
recombinationally_rearranged	ZMAPSTYLE_MODE_BASIC	ZMAPHOMOL_NONE
recombinationally_rearranged_vertebrate_immune_system_gene	ZMAPSTYLE_MODE_BASIC	ZMAPHOMOL_NONE
attP_site	ZMAPSTYLE_MODE_BASIC	ZMAPHOMOL_NONE
attB_site	ZMAPSTYLE_MODE_BASIC	ZMAPHOMOL_NONE
attL_site	ZMAPSTYLE_MODE_BASIC	ZMAPHOMOL_NONE
attR_site	ZMAPSTYLE_MODE_BASIC	ZMAPHOMOL_NONE
integration_excision_site	ZMAPSTYLE_MODE_BASIC	ZMAPHOMOL_NONE
resolution_site	ZMAPSTYLE_MODE_BASIC	ZMAPHOMOL_NONE
inversion_site	ZMAPSTYLE_MODE_BASIC	ZMAPHOMOL_NONE
dif_site	ZMAPSTYLE_MODE_BASIC	ZMAPHOMOL_NONE
attC_site	ZMAPSTYLE_MODE_BASIC	ZMAPHOMOL_NONE
eukaryotic_terminator	ZMAPSTYLE_MODE_BASIC	ZMAPHOMOL_NONE
oriV	ZMAPSTYLE_MODE_BASIC	ZMAPHOMOL_NONE
oriC	ZMAPSTYLE_MODE_BASIC	ZMAPHOMOL_NONE
DNA_chromosome	ZMAPSTYLE_MODE_BASIC	ZMAPHOMOL_NONE
double_stranded_DNA_chromosome	ZMAPSTYLE_MODE_BASIC	ZMAPHOMOL_NONE
single_stranded_DNA_chromosome	ZMAPSTYLE_MODE_BASIC	ZMAPHOMOL_NONE
linear_double_stranded_DNA_chromosome	ZMAPSTYLE_MODE_BASIC	ZMAPHOMOL_NONE
circular_double_stranded_DNA_chromosome	ZMAPSTYLE_MODE_BASIC	ZMAPHOMOL_NONE
linear_single_stranded_DNA_chromosome	ZMAPSTYLE_MODE_BASIC	ZMAPHOMOL_NONE
circular_single_stranded_DNA_chromosome	ZMAPSTYLE_MODE_BASIC	ZMAPHOMOL_NONE
RNA_chromosome	ZMAPSTYLE_MODE_BASIC	ZMAPHOMOL_NONE
single_stranded_RNA_chromosome	ZMAPSTYLE_MODE_BASIC	ZMAPHOMOL_NONE
linear_single_stranded_RNA_chromosome	ZMAPSTYLE_MODE_BASIC	ZMAPHOMOL_NONE
linear_double_stranded_RNA_chromosome	ZMAPSTYLE_MODE_BASIC	ZMAPHOMOL_NONE
double_stranded_RNA_chromosome	ZMAPSTYLE_MODE_BASIC	ZMAPHOMOL_NONE
circular_single_stranded_RNA_chromosome	ZMAPSTYLE_MODE_BASIC	ZMAPHOMOL_NONE
circular_double_stranded_RNA_chromosome	ZMAPSTYLE_MODE_BASIC	ZMAPHOMOL_NONE
insertion_sequence	ZMAPSTYLE_MODE_BASIC	ZMAPHOMOL_NONE
minicircle_gene	ZMAPSTYLE_MODE_BASIC	ZMAPHOMOL_NONE
cryptic	ZMAPSTYLE_MODE_BASIC	ZMAPHOMOL_NONE
anchor_binding_site	ZMAPSTYLE_MODE_BASIC	ZMAPHOMOL_NONE
template_region	ZMAPSTYLE_MODE_BASIC	ZMAPHOMOL_NONE
gRNA_encoding	ZMAPSTYLE_MODE_BASIC	ZMAPHOMOL_NONE
minicircle	ZMAPSTYLE_MODE_BASIC	ZMAPHOMOL_NONE
rho_dependent_bacterial_terminator	ZMAPSTYLE_MODE_BASIC	ZMAPHOMOL_NONE
rho_independent_bacterial_terminator	ZMAPSTYLE_MODE_BASIC	ZMAPHOMOL_NONE
strand_attribute	ZMAPSTYLE_MODE_BASIC	ZMAPHOMOL_NONE
single	ZMAPSTYLE_MODE_BASIC	ZMAPHOMOL_NONE
double	ZMAPSTYLE_MODE_BASIC	ZMAPHOMOL_NONE
topology_attribute	ZMAPSTYLE_MODE_BASIC	ZMAPHOMOL_NONE
linear	ZMAPSTYLE_MODE_BASIC	ZMAPHOMOL_NONE
circular	ZMAPSTYLE_MODE_BASIC	ZMAPHOMOL_NONE
class_II_RNA	ZMAPSTYLE_MODE_BASIC	ZMAPHOMOL_NONE
class_I_RNA	ZMAPSTYLE_MODE_BASIC	ZMAPHOMOL_NONE
genomic_DNA	ZMAPSTYLE_MODE_BASIC	ZMAPHOMOL_NONE
BAC_cloned_genomic_insert	ZMAPSTYLE_MODE_BASIC	ZMAPHOMOL_NONE
consensus	ZMAPSTYLE_MODE_BASIC	ZMAPHOMOL_NONE
consensus_region	ZMAPSTYLE_MODE_BASIC	ZMAPHOMOL_NONE
consensus_mRNA	ZMAPSTYLE_MODE_BASIC	ZMAPHOMOL_NONE
predicted_gene	ZMAPSTYLE_MODE_BASIC	ZMAPHOMOL_NONE
gene_fragment	ZMAPSTYLE_MODE_BASIC	ZMAPHOMOL_NONE
recursive_splice_site	ZMAPSTYLE_MODE_BASIC	ZMAPHOMOL_NONE
BAC_end	ZMAPSTYLE_MODE_BASIC	ZMAPHOMOL_NONE
rRNA_16S	ZMAPSTYLE_MODE_BASIC	ZMAPHOMOL_NONE
rRNA_23S	ZMAPSTYLE_MODE_BASIC	ZMAPHOMOL_NONE
rRNA_25S	ZMAPSTYLE_MODE_BASIC	ZMAPHOMOL_NONE
solo_LTR	ZMAPSTYLE_MODE_BASIC	ZMAPHOMOL_NONE
low_complexity	ZMAPSTYLE_MODE_BASIC	ZMAPHOMOL_NONE
low_complexity_region	ZMAPSTYLE_MODE_BASIC	ZMAPHOMOL_NONE
prophage	ZMAPSTYLE_MODE_BASIC	ZMAPHOMOL_NONE
cryptic_prophage	ZMAPSTYLE_MODE_BASIC	ZMAPHOMOL_NONE
tetraloop	ZMAPSTYLE_MODE_BASIC	ZMAPHOMOL_NONE
DNA_constraint_sequence	ZMAPSTYLE_MODE_BASIC	ZMAPHOMOL_NONE
i_motif	ZMAPSTYLE_MODE_BASIC	ZMAPHOMOL_NONE
PNA_oligo	ZMAPSTYLE_MODE_BASIC	ZMAPHOMOL_NONE
DNAzyme	ZMAPSTYLE_MODE_BASIC	ZMAPHOMOL_NONE
MNP	ZMAPSTYLE_MODE_BASIC	ZMAPHOMOL_NONE
intron_domain	ZMAPSTYLE_MODE_BASIC	ZMAPHOMOL_NONE
wobble_base_pair	ZMAPSTYLE_MODE_BASIC	ZMAPHOMOL_NONE
internal_guide_sequence	ZMAPSTYLE_MODE_BASIC	ZMAPHOMOL_NONE
silent_mutation	ZMAPSTYLE_MODE_BASIC	ZMAPHOMOL_NONE
epitope	ZMAPSTYLE_MODE_BASIC	ZMAPHOMOL_NONE
copy_number_variation	ZMAPSTYLE_MODE_BASIC	ZMAPHOMOL_NONE
chromosome_breakpoint	ZMAPSTYLE_MODE_BASIC	ZMAPHOMOL_NONE
inversion_breakpoint	ZMAPSTYLE_MODE_BASIC	ZMAPHOMOL_NONE
allele	ZMAPSTYLE_MODE_BASIC	ZMAPHOMOL_NONE
haplotype	ZMAPSTYLE_MODE_BASIC	ZMAPHOMOL_NONE
polymorphic_sequence_variant	ZMAPSTYLE_MODE_BASIC	ZMAPHOMOL_NONE
genome	ZMAPSTYLE_MODE_BASIC	ZMAPHOMOL_NONE
genotype	ZMAPSTYLE_MODE_BASIC	ZMAPHOMOL_NONE
diplotype	ZMAPSTYLE_MODE_BASIC	ZMAPHOMOL_NONE
direction_attribute	ZMAPSTYLE_MODE_BASIC	ZMAPHOMOL_NONE
forward	ZMAPSTYLE_MODE_BASIC	ZMAPHOMOL_NONE
reverse	ZMAPSTYLE_MODE_BASIC	ZMAPHOMOL_NONE
mitochondrial_DNA	ZMAPSTYLE_MODE_BASIC	ZMAPHOMOL_NONE
chloroplast_DNA	ZMAPSTYLE_MODE_BASIC	ZMAPHOMOL_NONE
mirtron	ZMAPSTYLE_MODE_BASIC	ZMAPHOMOL_NONE
piRNA	ZMAPSTYLE_MODE_BASIC	ZMAPHOMOL_NONE
arginyl_tRNA	ZMAPSTYLE_MODE_BASIC	ZMAPHOMOL_NONE
mobile_genetic_element	ZMAPSTYLE_MODE_BASIC	ZMAPHOMOL_NONE
extrachromosomal_mobile_genetic_element	ZMAPSTYLE_MODE_BASIC	ZMAPHOMOL_NONE
integrated_mobile_genetic_element	ZMAPSTYLE_MODE_BASIC	ZMAPHOMOL_NONE
integrated_plasmid	ZMAPSTYLE_MODE_BASIC	ZMAPHOMOL_NONE
viral_sequence	ZMAPSTYLE_MODE_BASIC	ZMAPHOMOL_NONE
phage_sequence	ZMAPSTYLE_MODE_BASIC	ZMAPHOMOL_NONE
attCtn_site	ZMAPSTYLE_MODE_BASIC	ZMAPHOMOL_NONE
nuclear_mt_pseudogene	ZMAPSTYLE_MODE_BASIC	ZMAPHOMOL_NONE
cointegrated_plasmid	ZMAPSTYLE_MODE_BASIC	ZMAPHOMOL_NONE
IRLinv_site	ZMAPSTYLE_MODE_BASIC	ZMAPHOMOL_NONE
IRRinv_site	ZMAPSTYLE_MODE_BASIC	ZMAPHOMOL_NONE
inversion_site_part	ZMAPSTYLE_MODE_BASIC	ZMAPHOMOL_NONE
defective_conjugative_transposon	ZMAPSTYLE_MODE_BASIC	ZMAPHOMOL_NONE
repeat_fragment	ZMAPSTYLE_MODE_BASIC	ZMAPHOMOL_NONE
transposon_fragment	ZMAPSTYLE_MODE_BASIC	ZMAPHOMOL_NONE
transcriptional_cis_regulatory_region	ZMAPSTYLE_MODE_BASIC	ZMAPHOMOL_NONE
splicing_regulatory_region	ZMAPSTYLE_MODE_BASIC	ZMAPHOMOL_NONE
promoter_targeting_sequence	ZMAPSTYLE_MODE_BASIC	ZMAPHOMOL_NONE
sequence_alteration	ZMAPSTYLE_MODE_BASIC	ZMAPHOMOL_NONE
sequence_variant	ZMAPSTYLE_MODE_BASIC	ZMAPHOMOL_NONE
propeptide_cleavage_site	ZMAPSTYLE_MODE_BASIC	ZMAPHOMOL_NONE
propeptide	ZMAPSTYLE_MODE_BASIC	ZMAPHOMOL_NONE
immature_peptide_region	ZMAPSTYLE_MODE_BASIC	ZMAPHOMOL_NONE
active_peptide	ZMAPSTYLE_MODE_BASIC	ZMAPHOMOL_NONE
compositionally_biased_region_of_peptide	ZMAPSTYLE_MODE_BASIC	ZMAPHOMOL_NONE
polypeptide_motif	ZMAPSTYLE_MODE_BASIC	ZMAPHOMOL_NONE
polypeptide_repeat	ZMAPSTYLE_MODE_BASIC	ZMAPHOMOL_NONE
polypeptide_structural_region	ZMAPSTYLE_MODE_BASIC	ZMAPHOMOL_NONE
membrane_structure	ZMAPSTYLE_MODE_BASIC	ZMAPHOMOL_NONE
extramembrane_polypeptide_region	ZMAPSTYLE_MODE_BASIC	ZMAPHOMOL_NONE
cytoplasmic_polypeptide_region	ZMAPSTYLE_MODE_BASIC	ZMAPHOMOL_NONE
non_cytoplasmic_polypeptide_region	ZMAPSTYLE_MODE_BASIC	ZMAPHOMOL_NONE
intramembrane_polypeptide_region	ZMAPSTYLE_MODE_BASIC	ZMAPHOMOL_NONE
membrane_peptide_loop	ZMAPSTYLE_MODE_BASIC	ZMAPHOMOL_NONE
transmembrane_polypeptide_region	ZMAPSTYLE_MODE_BASIC	ZMAPHOMOL_NONE
polypeptide_secondary_structure	ZMAPSTYLE_MODE_BASIC	ZMAPHOMOL_NONE
polypeptide_structural_motif	ZMAPSTYLE_MODE_BASIC	ZMAPHOMOL_NONE
coiled_coil	ZMAPSTYLE_MODE_BASIC	ZMAPHOMOL_NONE
helix_turn_helix	ZMAPSTYLE_MODE_BASIC	ZMAPHOMOL_NONE
polypeptide_sequencing_information	ZMAPSTYLE_MODE_BASIC	ZMAPHOMOL_NONE
non_adjacent_residues	ZMAPSTYLE_MODE_BASIC	ZMAPHOMOL_NONE
non_terminal_residue	ZMAPSTYLE_MODE_BASIC	ZMAPHOMOL_NONE
sequence_conflict	ZMAPSTYLE_MODE_BASIC	ZMAPHOMOL_NONE
sequence_uncertainty	ZMAPSTYLE_MODE_BASIC	ZMAPHOMOL_NONE
post_translationally_modified_region	ZMAPSTYLE_MODE_BASIC	ZMAPHOMOL_NONE
polypeptide_metal_contact	ZMAPSTYLE_MODE_BASIC	ZMAPHOMOL_NONE
protein_protein_contact	ZMAPSTYLE_MODE_BASIC	ZMAPHOMOL_NONE
polypeptide_calcium_ion_contact_site	ZMAPSTYLE_MODE_BASIC	ZMAPHOMOL_NONE
polypeptide_cobalt_ion_contact_site	ZMAPSTYLE_MODE_BASIC	ZMAPHOMOL_NONE
polypeptide_copper_ion_contact_site	ZMAPSTYLE_MODE_BASIC	ZMAPHOMOL_NONE
polypeptide_iron_ion_contact_site	ZMAPSTYLE_MODE_BASIC	ZMAPHOMOL_NONE
polypeptide_magnesium_ion_contact_site	ZMAPSTYLE_MODE_BASIC	ZMAPHOMOL_NONE
polypeptide_manganese_ion_contact_site	ZMAPSTYLE_MODE_BASIC	ZMAPHOMOL_NONE
polypeptide_molybdenum_ion_contact_site	ZMAPSTYLE_MODE_BASIC	ZMAPHOMOL_NONE
polypeptide_nickel_ion_contact_site	ZMAPSTYLE_MODE_BASIC	ZMAPHOMOL_NONE
polypeptide_tungsten_ion_contact_site	ZMAPSTYLE_MODE_BASIC	ZMAPHOMOL_NONE
polypeptide_zinc_ion_contact_site	ZMAPSTYLE_MODE_BASIC	ZMAPHOMOL_NONE
catalytic_residue	ZMAPSTYLE_MODE_BASIC	ZMAPHOMOL_NONE
polypeptide_ligand_contact	ZMAPSTYLE_MODE_BASIC	ZMAPHOMOL_NONE
asx_motif	ZMAPSTYLE_MODE_BASIC	ZMAPHOMOL_NONE
beta_bulge	ZMAPSTYLE_MODE_BASIC	ZMAPHOMOL_NONE
beta_bulge_loop	ZMAPSTYLE_MODE_BASIC	ZMAPHOMOL_NONE
beta_bulge_loop_five	ZMAPSTYLE_MODE_BASIC	ZMAPHOMOL_NONE
beta_bulge_loop_six	ZMAPSTYLE_MODE_BASIC	ZMAPHOMOL_NONE
beta_strand	ZMAPSTYLE_MODE_BASIC	ZMAPHOMOL_NONE
antiparallel_beta_strand	ZMAPSTYLE_MODE_BASIC	ZMAPHOMOL_NONE
parallel_beta_strand	ZMAPSTYLE_MODE_BASIC	ZMAPHOMOL_NONE
peptide_helix	ZMAPSTYLE_MODE_BASIC	ZMAPHOMOL_NONE
left_handed_peptide_helix	ZMAPSTYLE_MODE_BASIC	ZMAPHOMOL_NONE
right_handed_peptide_helix	ZMAPSTYLE_MODE_BASIC	ZMAPHOMOL_NONE
alpha_helix	ZMAPSTYLE_MODE_BASIC	ZMAPHOMOL_NONE
pi_helix	ZMAPSTYLE_MODE_BASIC	ZMAPHOMOL_NONE
three_ten_helix	ZMAPSTYLE_MODE_BASIC	ZMAPHOMOL_NONE
polypeptide_nest_motif	ZMAPSTYLE_MODE_BASIC	ZMAPHOMOL_NONE
polypeptide_nest_left_right_motif	ZMAPSTYLE_MODE_BASIC	ZMAPHOMOL_NONE
polypeptide_nest_right_left_motif	ZMAPSTYLE_MODE_BASIC	ZMAPHOMOL_NONE
schellmann_loop	ZMAPSTYLE_MODE_BASIC	ZMAPHOMOL_NONE
schellmann_loop_seven	ZMAPSTYLE_MODE_BASIC	ZMAPHOMOL_NONE
schellmann_loop_six	ZMAPSTYLE_MODE_BASIC	ZMAPHOMOL_NONE
serine_threonine_motif	ZMAPSTYLE_MODE_BASIC	ZMAPHOMOL_NONE
serine_threonine_staple_motif	ZMAPSTYLE_MODE_BASIC	ZMAPHOMOL_NONE
polypeptide_turn_motif	ZMAPSTYLE_MODE_BASIC	ZMAPHOMOL_NONE
asx_turn_left_handed_type_one	ZMAPSTYLE_MODE_BASIC	ZMAPHOMOL_NONE
asx_turn_left_handed_type_two	ZMAPSTYLE_MODE_BASIC	ZMAPHOMOL_NONE
asx_turn_right_handed_type_two	ZMAPSTYLE_MODE_BASIC	ZMAPHOMOL_NONE
asx_turn_right_handed_type_one	ZMAPSTYLE_MODE_BASIC	ZMAPHOMOL_NONE
beta_turn	ZMAPSTYLE_MODE_BASIC	ZMAPHOMOL_NONE
beta_turn_left_handed_type_one	ZMAPSTYLE_MODE_BASIC	ZMAPHOMOL_NONE
beta_turn_left_handed_type_two	ZMAPSTYLE_MODE_BASIC	ZMAPHOMOL_NONE
beta_turn_right_handed_type_one	ZMAPSTYLE_MODE_BASIC	ZMAPHOMOL_NONE
beta_turn_right_handed_type_two	ZMAPSTYLE_MODE_BASIC	ZMAPHOMOL_NONE
gamma_turn	ZMAPSTYLE_MODE_BASIC	ZMAPHOMOL_NONE
gamma_turn_classic	ZMAPSTYLE_MODE_BASIC	ZMAPHOMOL_NONE
gamma_turn_inverse	ZMAPSTYLE_MODE_BASIC	ZMAPHOMOL_NONE
serine_threonine_turn	ZMAPSTYLE_MODE_BASIC	ZMAPHOMOL_NONE
st_turn_left_handed_type_one	ZMAPSTYLE_MODE_BASIC	ZMAPHOMOL_NONE
st_turn_left_handed_type_two	ZMAPSTYLE_MODE_BASIC	ZMAPHOMOL_NONE
st_turn_right_handed_type_one	ZMAPSTYLE_MODE_BASIC	ZMAPHOMOL_NONE
st_turn_right_handed_type_two	ZMAPSTYLE_MODE_BASIC	ZMAPHOMOL_NONE
polypeptide_variation_site	ZMAPSTYLE_MODE_BASIC	ZMAPHOMOL_NONE
natural_variant_site	ZMAPSTYLE_MODE_BASIC	ZMAPHOMOL_NONE
mutated_variant_site	ZMAPSTYLE_MODE_BASIC	ZMAPHOMOL_NONE
alternate_sequence_site	ZMAPSTYLE_MODE_BASIC	ZMAPHOMOL_NONE
beta_turn_type_six	ZMAPSTYLE_MODE_BASIC	ZMAPHOMOL_NONE
beta_turn_type_six_a	ZMAPSTYLE_MODE_BASIC	ZMAPHOMOL_NONE
beta_turn_type_six_a_one	ZMAPSTYLE_MODE_BASIC	ZMAPHOMOL_NONE
beta_turn_type_six_a_two	ZMAPSTYLE_MODE_BASIC	ZMAPHOMOL_NONE
beta_turn_type_six_b	ZMAPSTYLE_MODE_BASIC	ZMAPHOMOL_NONE
beta_turn_type_eight	ZMAPSTYLE_MODE_BASIC	ZMAPHOMOL_NONE
DRE_motif	ZMAPSTYLE_MODE_BASIC	ZMAPHOMOL_NONE
DMv4_motif	ZMAPSTYLE_MODE_BASIC	ZMAPHOMOL_NONE
E_box_motif	ZMAPSTYLE_MODE_BASIC	ZMAPHOMOL_NONE
DMv5_motif	ZMAPSTYLE_MODE_BASIC	ZMAPHOMOL_NONE
DMv3_motif	ZMAPSTYLE_MODE_BASIC	ZMAPHOMOL_NONE
DMv2_motif	ZMAPSTYLE_MODE_BASIC	ZMAPHOMOL_NONE
MTE	ZMAPSTYLE_MODE_BASIC	ZMAPHOMOL_NONE
INR1_motif	ZMAPSTYLE_MODE_BASIC	ZMAPHOMOL_NONE
DPE1_motif	ZMAPSTYLE_MODE_BASIC	ZMAPHOMOL_NONE
DMv1_motif	ZMAPSTYLE_MODE_BASIC	ZMAPHOMOL_NONE
GAGA_motif	ZMAPSTYLE_MODE_BASIC	ZMAPHOMOL_NONE
NDM2_motif	ZMAPSTYLE_MODE_BASIC	ZMAPHOMOL_NONE
NDM3_motif	ZMAPSTYLE_MODE_BASIC	ZMAPHOMOL_NONE
ds_RNA_viral_sequence	ZMAPSTYLE_MODE_BASIC	ZMAPHOMOL_NONE
polinton	ZMAPSTYLE_MODE_BASIC	ZMAPHOMOL_NONE
rRNA_21S	ZMAPSTYLE_MODE_BASIC	ZMAPHOMOL_NONE
tRNA_region	ZMAPSTYLE_MODE_BASIC	ZMAPHOMOL_NONE
anticodon_loop	ZMAPSTYLE_MODE_BASIC	ZMAPHOMOL_NONE
anticodon	ZMAPSTYLE_MODE_BASIC	ZMAPHOMOL_NONE
CCA_tail	ZMAPSTYLE_MODE_BASIC	ZMAPHOMOL_NONE
DHU_loop	ZMAPSTYLE_MODE_BASIC	ZMAPHOMOL_NONE
T_loop	ZMAPSTYLE_MODE_BASIC	ZMAPHOMOL_NONE
pyrrolysine_tRNA_primary_transcript	ZMAPSTYLE_MODE_TRANSCRIPT	ZMAPHOMOL_NONE
U3_snoRNA	ZMAPSTYLE_MODE_BASIC	ZMAPHOMOL_NONE
AU_rich_element	ZMAPSTYLE_MODE_BASIC	ZMAPHOMOL_NONE
Bruno_response_element	ZMAPSTYLE_MODE_BASIC	ZMAPHOMOL_NONE
iron_responsive_element	ZMAPSTYLE_MODE_BASIC	ZMAPHOMOL_NONE
morpholino_backbone	ZMAPSTYLE_MODE_BASIC	ZMAPHOMOL_NONE
PNA	ZMAPSTYLE_MODE_BASIC	ZMAPHOMOL_NONE
enzymatic	ZMAPSTYLE_MODE_BASIC	ZMAPHOMOL_NONE
ribozymic	ZMAPSTYLE_MODE_BASIC	ZMAPHOMOL_NONE
pseudouridylation_guide_snoRNA	ZMAPSTYLE_MODE_BASIC	ZMAPHOMOL_NONE
LNA	ZMAPSTYLE_MODE_BASIC	ZMAPHOMOL_NONE
LNA_oligo	ZMAPSTYLE_MODE_BASIC	ZMAPHOMOL_NONE
TNA	ZMAPSTYLE_MODE_BASIC	ZMAPHOMOL_NONE
TNA_oligo	ZMAPSTYLE_MODE_BASIC	ZMAPHOMOL_NONE
GNA	ZMAPSTYLE_MODE_BASIC	ZMAPHOMOL_NONE
GNA_oligo	ZMAPSTYLE_MODE_BASIC	ZMAPHOMOL_NONE
R_GNA	ZMAPSTYLE_MODE_BASIC	ZMAPHOMOL_NONE
R_GNA_oligo	ZMAPSTYLE_MODE_BASIC	ZMAPHOMOL_NONE
S_GNA	ZMAPSTYLE_MODE_BASIC	ZMAPHOMOL_NONE
S_GNA_oligo	ZMAPSTYLE_MODE_BASIC	ZMAPHOMOL_NONE
ds_DNA_viral_sequence	ZMAPSTYLE_MODE_BASIC	ZMAPHOMOL_NONE
ss_RNA_viral_sequence	ZMAPSTYLE_MODE_BASIC	ZMAPHOMOL_NONE
negative_sense_ssRNA_viral_sequence	ZMAPSTYLE_MODE_BASIC	ZMAPHOMOL_NONE
positive_sense_ssRNA_viral_sequence	ZMAPSTYLE_MODE_BASIC	ZMAPHOMOL_NONE
ambisense_ssRNA_viral_sequence	ZMAPSTYLE_MODE_BASIC	ZMAPHOMOL_NONE
RNA_polymerase_promoter	ZMAPSTYLE_MODE_BASIC	ZMAPHOMOL_NONE
Phage_RNA_Polymerase_Promoter	ZMAPSTYLE_MODE_BASIC	ZMAPHOMOL_NONE
SP6_RNA_Polymerase_Promoter	ZMAPSTYLE_MODE_BASIC	ZMAPHOMOL_NONE
T3_RNA_Polymerase_Promoter	ZMAPSTYLE_MODE_BASIC	ZMAPHOMOL_NONE
T7_RNA_Polymerase_Promoter	ZMAPSTYLE_MODE_BASIC	ZMAPHOMOL_NONE
five_prime_EST	ZMAPSTYLE_MODE_BASIC	ZMAPHOMOL_NONE
three_prime_EST	ZMAPSTYLE_MODE_BASIC	ZMAPHOMOL_NONE
translational_frameshift	ZMAPSTYLE_MODE_BASIC	ZMAPHOMOL_NONE
plus_1_translational_frameshift	ZMAPSTYLE_MODE_BASIC	ZMAPHOMOL_NONE
plus_2_translational_frameshift	ZMAPSTYLE_MODE_BASIC	ZMAPHOMOL_NONE
group_III_intron	ZMAPSTYLE_MODE_BASIC	ZMAPHOMOL_NONE
noncoding_region_of_exon	ZMAPSTYLE_MODE_BASIC	ZMAPHOMOL_NONE
coding_region_of_exon	ZMAPSTYLE_MODE_BASIC	ZMAPHOMOL_NONE
endonuclease_spliced_intron	ZMAPSTYLE_MODE_BASIC	ZMAPHOMOL_NONE
protein_coding_gene	ZMAPSTYLE_MODE_BASIC	ZMAPHOMOL_NONE
transgenic_insertion	ZMAPSTYLE_MODE_BASIC	ZMAPHOMOL_NONE
retrogene	ZMAPSTYLE_MODE_BASIC	ZMAPHOMOL_NONE
silenced_by_RNA_interference	ZMAPSTYLE_MODE_BASIC	ZMAPHOMOL_NONE
silenced_by_histone_modification	ZMAPSTYLE_MODE_BASIC	ZMAPHOMOL_NONE
silenced_by_histone_methylation	ZMAPSTYLE_MODE_BASIC	ZMAPHOMOL_NONE
silenced_by_histone_deacetylation	ZMAPSTYLE_MODE_BASIC	ZMAPHOMOL_NONE
gene_silenced_by_RNA_interference	ZMAPSTYLE_MODE_BASIC	ZMAPHOMOL_NONE
gene_silenced_by_histone_modification	ZMAPSTYLE_MODE_BASIC	ZMAPHOMOL_NONE
gene_silenced_by_histone_methylation	ZMAPSTYLE_MODE_BASIC	ZMAPHOMOL_NONE
gene_silenced_by_histone_deacetylation	ZMAPSTYLE_MODE_BASIC	ZMAPHOMOL_NONE
dihydrouridine	ZMAPSTYLE_MODE_BASIC	ZMAPHOMOL_NONE
pseudouridine	ZMAPSTYLE_MODE_BASIC	ZMAPHOMOL_NONE
inosine	ZMAPSTYLE_MODE_BASIC	ZMAPHOMOL_NONE
seven_methylguanine	ZMAPSTYLE_MODE_BASIC	ZMAPHOMOL_NONE
ribothymidine	ZMAPSTYLE_MODE_BASIC	ZMAPHOMOL_NONE
methylinosine	ZMAPSTYLE_MODE_BASIC	ZMAPHOMOL_NONE
mobile	ZMAPSTYLE_MODE_BASIC	ZMAPHOMOL_NONE
replicon	ZMAPSTYLE_MODE_BASIC	ZMAPHOMOL_NONE
base	ZMAPSTYLE_MODE_BASIC	ZMAPHOMOL_NONE
amino_acid	ZMAPSTYLE_MODE_BASIC	ZMAPHOMOL_NONE
major_TSS	ZMAPSTYLE_MODE_BASIC	ZMAPHOMOL_NONE
minor_TSS	ZMAPSTYLE_MODE_BASIC	ZMAPHOMOL_NONE
TSS_region	ZMAPSTYLE_MODE_BASIC	ZMAPHOMOL_NONE
encodes_alternate_transcription_start_sites	ZMAPSTYLE_MODE_TRANSCRIPT	ZMAPHOMOL_NONE
miRNA_primary_transcript_region	ZMAPSTYLE_MODE_TRANSCRIPT	ZMAPHOMOL_NONE
pre_miRNA	ZMAPSTYLE_MODE_BASIC	ZMAPHOMOL_NONE
miRNA_stem	ZMAPSTYLE_MODE_BASIC	ZMAPHOMOL_NONE
miRNA_loop	ZMAPSTYLE_MODE_BASIC	ZMAPHOMOL_NONE
synthetic_oligo	ZMAPSTYLE_MODE_BASIC	ZMAPHOMOL_NONE
assembly	ZMAPSTYLE_MODE_BASIC	ZMAPHOMOL_NONE
fragment_assembly	ZMAPSTYLE_MODE_BASIC	ZMAPHOMOL_NONE
fingerprint_map	ZMAPSTYLE_MODE_BASIC	ZMAPHOMOL_NONE
STS_map	ZMAPSTYLE_MODE_BASIC	ZMAPHOMOL_NONE
RH_map	ZMAPSTYLE_MODE_BASIC	ZMAPHOMOL_NONE
sonicate_fragment	ZMAPSTYLE_MODE_BASIC	ZMAPHOMOL_NONE
polyploid	ZMAPSTYLE_MODE_BASIC	ZMAPHOMOL_NONE
autopolyploid	ZMAPSTYLE_MODE_BASIC	ZMAPHOMOL_NONE
allopolyploid	ZMAPSTYLE_MODE_BASIC	ZMAPHOMOL_NONE
homing_endonuclease_binding_site	ZMAPSTYLE_MODE_BASIC	ZMAPHOMOL_NONE
octamer_motif	ZMAPSTYLE_MODE_BASIC	ZMAPHOMOL_NONE
apicoplast_chromosome	ZMAPSTYLE_MODE_BASIC	ZMAPHOMOL_NONE
sequence_collection	ZMAPSTYLE_MODE_BASIC	ZMAPHOMOL_NONE
overlapping_feature_set	ZMAPSTYLE_MODE_BASIC	ZMAPHOMOL_NONE
overlapping_EST_set	ZMAPSTYLE_MODE_BASIC	ZMAPHOMOL_NONE
ncRNA_gene	ZMAPSTYLE_MODE_BASIC	ZMAPHOMOL_NONE
gRNA_gene	ZMAPSTYLE_MODE_BASIC	ZMAPHOMOL_NONE
miRNA_gene	ZMAPSTYLE_MODE_BASIC	ZMAPHOMOL_NONE
scRNA_gene	ZMAPSTYLE_MODE_BASIC	ZMAPHOMOL_NONE
snoRNA_gene	ZMAPSTYLE_MODE_BASIC	ZMAPHOMOL_NONE
snRNA_gene	ZMAPSTYLE_MODE_BASIC	ZMAPHOMOL_NONE
SRP_RNA_gene	ZMAPSTYLE_MODE_BASIC	ZMAPHOMOL_NONE
stRNA_gene	ZMAPSTYLE_MODE_BASIC	ZMAPHOMOL_NONE
tmRNA_gene	ZMAPSTYLE_MODE_BASIC	ZMAPHOMOL_NONE
tRNA_gene	ZMAPSTYLE_MODE_BASIC	ZMAPHOMOL_NONE
modified_adenosine	ZMAPSTYLE_MODE_BASIC	ZMAPHOMOL_NONE
modified_inosine	ZMAPSTYLE_MODE_BASIC	ZMAPHOMOL_NONE
modified_cytidine	ZMAPSTYLE_MODE_BASIC	ZMAPHOMOL_NONE
modified_guanosine	ZMAPSTYLE_MODE_BASIC	ZMAPHOMOL_NONE
modified_uridine	ZMAPSTYLE_MODE_BASIC	ZMAPHOMOL_NONE
one_methylinosine	ZMAPSTYLE_MODE_BASIC	ZMAPHOMOL_NONE
one_two_prime_O_dimethylinosine	ZMAPSTYLE_MODE_BASIC	ZMAPHOMOL_NONE
two_prime_O_methylinosine	ZMAPSTYLE_MODE_BASIC	ZMAPHOMOL_NONE
three_methylcytidine	ZMAPSTYLE_MODE_BASIC	ZMAPHOMOL_NONE
five_methylcytidine	ZMAPSTYLE_MODE_BASIC	ZMAPHOMOL_NONE
two_prime_O_methylcytidine	ZMAPSTYLE_MODE_BASIC	ZMAPHOMOL_NONE
two_thiocytidine	ZMAPSTYLE_MODE_BASIC	ZMAPHOMOL_NONE
N4_acetylcytidine	ZMAPSTYLE_MODE_BASIC	ZMAPHOMOL_NONE
five_formylcytidine	ZMAPSTYLE_MODE_BASIC	ZMAPHOMOL_NONE
five_two_prime_O_dimethylcytidine	ZMAPSTYLE_MODE_BASIC	ZMAPHOMOL_NONE
N4_acetyl_2_prime_O_methylcytidine	ZMAPSTYLE_MODE_BASIC	ZMAPHOMOL_NONE
lysidine	ZMAPSTYLE_MODE_BASIC	ZMAPHOMOL_NONE
N4_methylcytidine	ZMAPSTYLE_MODE_BASIC	ZMAPHOMOL_NONE
N4_2_prime_O_dimethylcytidine	ZMAPSTYLE_MODE_BASIC	ZMAPHOMOL_NONE
five_hydroxymethylcytidine	ZMAPSTYLE_MODE_BASIC	ZMAPHOMOL_NONE
five_formyl_two_prime_O_methylcytidine	ZMAPSTYLE_MODE_BASIC	ZMAPHOMOL_NONE
N4_N4_2_prime_O_trimethylcytidine	ZMAPSTYLE_MODE_BASIC	ZMAPHOMOL_NONE
one_methyladenosine	ZMAPSTYLE_MODE_BASIC	ZMAPHOMOL_NONE
two_methyladenosine	ZMAPSTYLE_MODE_BASIC	ZMAPHOMOL_NONE
N6_methyladenosine	ZMAPSTYLE_MODE_BASIC	ZMAPHOMOL_NONE
two_prime_O_methyladenosine	ZMAPSTYLE_MODE_BASIC	ZMAPHOMOL_NONE
two_methylthio_N6_methyladenosine	ZMAPSTYLE_MODE_BASIC	ZMAPHOMOL_NONE
N6_isopentenyladenosine	ZMAPSTYLE_MODE_BASIC	ZMAPHOMOL_NONE
two_methylthio_N6_isopentenyladenosine	ZMAPSTYLE_MODE_BASIC	ZMAPHOMOL_NONE
N6_cis_hydroxyisopentenyl_adenosine	ZMAPSTYLE_MODE_BASIC	ZMAPHOMOL_NONE
two_methylthio_N6_cis_hydroxyisopentenyl_adenosine	ZMAPSTYLE_MODE_BASIC	ZMAPHOMOL_NONE
N6_glycinylcarbamoyladenosine	ZMAPSTYLE_MODE_BASIC	ZMAPHOMOL_NONE
N6_threonylcarbamoyladenosine	ZMAPSTYLE_MODE_BASIC	ZMAPHOMOL_NONE
two_methylthio_N6_threonyl_carbamoyladenosine	ZMAPSTYLE_MODE_BASIC	ZMAPHOMOL_NONE
N6_methyl_N6_threonylcarbamoyladenosine	ZMAPSTYLE_MODE_BASIC	ZMAPHOMOL_NONE
N6_hydroxynorvalylcarbamoyladenosine	ZMAPSTYLE_MODE_BASIC	ZMAPHOMOL_NONE
two_methylthio_N6_hydroxynorvalyl_carbamoyladenosine	ZMAPSTYLE_MODE_BASIC	ZMAPHOMOL_NONE
two_prime_O_ribosyladenosine_phosphate	ZMAPSTYLE_MODE_BASIC	ZMAPHOMOL_NONE
N6_N6_dimethyladenosine	ZMAPSTYLE_MODE_BASIC	ZMAPHOMOL_NONE
N6_2_prime_O_dimethyladenosine	ZMAPSTYLE_MODE_BASIC	ZMAPHOMOL_NONE
N6_N6_2_prime_O_trimethyladenosine	ZMAPSTYLE_MODE_BASIC	ZMAPHOMOL_NONE
one_two_prime_O_dimethyladenosine	ZMAPSTYLE_MODE_BASIC	ZMAPHOMOL_NONE
N6_acetyladenosine	ZMAPSTYLE_MODE_BASIC	ZMAPHOMOL_NONE
seven_deazaguanosine	ZMAPSTYLE_MODE_BASIC	ZMAPHOMOL_NONE
queuosine	ZMAPSTYLE_MODE_BASIC	ZMAPHOMOL_NONE
epoxyqueuosine	ZMAPSTYLE_MODE_BASIC	ZMAPHOMOL_NONE
galactosyl_queuosine	ZMAPSTYLE_MODE_BASIC	ZMAPHOMOL_NONE
mannosyl_queuosine	ZMAPSTYLE_MODE_BASIC	ZMAPHOMOL_NONE
seven_cyano_seven_deazaguanosine	ZMAPSTYLE_MODE_BASIC	ZMAPHOMOL_NONE
seven_aminomethyl_seven_deazaguanosine	ZMAPSTYLE_MODE_BASIC	ZMAPHOMOL_NONE
archaeosine	ZMAPSTYLE_MODE_BASIC	ZMAPHOMOL_NONE
one_methylguanosine	ZMAPSTYLE_MODE_BASIC	ZMAPHOMOL_NONE
N2_methylguanosine	ZMAPSTYLE_MODE_BASIC	ZMAPHOMOL_NONE
seven_methylguanosine	ZMAPSTYLE_MODE_BASIC	ZMAPHOMOL_NONE
two_prime_O_methylguanosine	ZMAPSTYLE_MODE_BASIC	ZMAPHOMOL_NONE
N2_N2_dimethylguanosine	ZMAPSTYLE_MODE_BASIC	ZMAPHOMOL_NONE
N2_2_prime_O_dimethylguanosine	ZMAPSTYLE_MODE_BASIC	ZMAPHOMOL_NONE
N2_N2_2_prime_O_trimethylguanosine	ZMAPSTYLE_MODE_BASIC	ZMAPHOMOL_NONE
two_prime_O_ribosylguanosine_phosphate	ZMAPSTYLE_MODE_BASIC	ZMAPHOMOL_NONE
wybutosine	ZMAPSTYLE_MODE_BASIC	ZMAPHOMOL_NONE
peroxywybutosine	ZMAPSTYLE_MODE_BASIC	ZMAPHOMOL_NONE
hydroxywybutosine	ZMAPSTYLE_MODE_BASIC	ZMAPHOMOL_NONE
undermodified_hydroxywybutosine	ZMAPSTYLE_MODE_BASIC	ZMAPHOMOL_NONE
wyosine	ZMAPSTYLE_MODE_BASIC	ZMAPHOMOL_NONE
methylwyosine	ZMAPSTYLE_MODE_BASIC	ZMAPHOMOL_NONE
N2_7_dimethylguanosine	ZMAPSTYLE_MODE_BASIC	ZMAPHOMOL_NONE
N2_N2_7_trimethylguanosine	ZMAPSTYLE_MODE_BASIC	ZMAPHOMOL_NONE
one_two_prime_O_dimethylguanosine	ZMAPSTYLE_MODE_BASIC	ZMAPHOMOL_NONE
four_demethylwyosine	ZMAPSTYLE_MODE_BASIC	ZMAPHOMOL_NONE
isowyosine	ZMAPSTYLE_MODE_BASIC	ZMAPHOMOL_NONE
N2_7_2prirme_O_trimethylguanosine	ZMAPSTYLE_MODE_BASIC	ZMAPHOMOL_NONE
five_methyluridine	ZMAPSTYLE_MODE_BASIC	ZMAPHOMOL_NONE
two_prime_O_methyluridine	ZMAPSTYLE_MODE_BASIC	ZMAPHOMOL_NONE
five_two_prime_O_dimethyluridine	ZMAPSTYLE_MODE_BASIC	ZMAPHOMOL_NONE
one_methylpseudouridine	ZMAPSTYLE_MODE_BASIC	ZMAPHOMOL_NONE
two_prime_O_methylpseudouridine	ZMAPSTYLE_MODE_BASIC	ZMAPHOMOL_NONE
two_thiouridine	ZMAPSTYLE_MODE_BASIC	ZMAPHOMOL_NONE
four_thiouridine	ZMAPSTYLE_MODE_BASIC	ZMAPHOMOL_NONE
five_methyl_2_thiouridine	ZMAPSTYLE_MODE_BASIC	ZMAPHOMOL_NONE
two_thio_two_prime_O_methyluridine	ZMAPSTYLE_MODE_BASIC	ZMAPHOMOL_NONE
three_three_amino_three_carboxypropyl_uridine	ZMAPSTYLE_MODE_BASIC	ZMAPHOMOL_NONE
five_hydroxyuridine	ZMAPSTYLE_MODE_BASIC	ZMAPHOMOL_NONE
five_methoxyuridine	ZMAPSTYLE_MODE_BASIC	ZMAPHOMOL_NONE
uridine_five_oxyacetic_acid	ZMAPSTYLE_MODE_BASIC	ZMAPHOMOL_NONE
uridine_five_oxyacetic_acid_methyl_ester	ZMAPSTYLE_MODE_BASIC	ZMAPHOMOL_NONE
five_carboxyhydroxymethyl_uridine	ZMAPSTYLE_MODE_BASIC	ZMAPHOMOL_NONE
five_carboxyhydroxymethyl_uridine_methyl_ester	ZMAPSTYLE_MODE_BASIC	ZMAPHOMOL_NONE
five_methoxycarbonylmethyluridine	ZMAPSTYLE_MODE_BASIC	ZMAPHOMOL_NONE
five_methoxycarbonylmethyl_two_prime_O_methyluridine	ZMAPSTYLE_MODE_BASIC	ZMAPHOMOL_NONE
five_methoxycarbonylmethyl_two_thiouridine	ZMAPSTYLE_MODE_BASIC	ZMAPHOMOL_NONE
five_aminomethyl_two_thiouridine	ZMAPSTYLE_MODE_BASIC	ZMAPHOMOL_NONE
five_methylaminomethyluridine	ZMAPSTYLE_MODE_BASIC	ZMAPHOMOL_NONE
five_methylaminomethyl_two_thiouridine	ZMAPSTYLE_MODE_BASIC	ZMAPHOMOL_NONE
five_methylaminomethyl_two_selenouridine	ZMAPSTYLE_MODE_BASIC	ZMAPHOMOL_NONE
five_carbamoylmethyluridine	ZMAPSTYLE_MODE_BASIC	ZMAPHOMOL_NONE
five_carbamoylmethyl_two_prime_O_methyluridine	ZMAPSTYLE_MODE_BASIC	ZMAPHOMOL_NONE
five_carboxymethylaminomethyluridine	ZMAPSTYLE_MODE_BASIC	ZMAPHOMOL_NONE
five_carboxymethylaminomethyl_two_prime_O_methyluridine	ZMAPSTYLE_MODE_BASIC	ZMAPHOMOL_NONE
five_carboxymethylaminomethyl_two_thiouridine	ZMAPSTYLE_MODE_BASIC	ZMAPHOMOL_NONE
three_methyluridine	ZMAPSTYLE_MODE_BASIC	ZMAPHOMOL_NONE
one_methyl_three_three_amino_three_carboxypropyl_pseudouridine	ZMAPSTYLE_MODE_BASIC	ZMAPHOMOL_NONE
five_carboxymethyluridine	ZMAPSTYLE_MODE_BASIC	ZMAPHOMOL_NONE
three_two_prime_O_dimethyluridine	ZMAPSTYLE_MODE_BASIC	ZMAPHOMOL_NONE
five_methyldihydrouridine	ZMAPSTYLE_MODE_BASIC	ZMAPHOMOL_NONE
three_methylpseudouridine	ZMAPSTYLE_MODE_BASIC	ZMAPHOMOL_NONE
five_taurinomethyluridine	ZMAPSTYLE_MODE_BASIC	ZMAPHOMOL_NONE
five_taurinomethyl_two_thiouridine	ZMAPSTYLE_MODE_BASIC	ZMAPHOMOL_NONE
five_isopentenylaminomethyl_uridine	ZMAPSTYLE_MODE_BASIC	ZMAPHOMOL_NONE
five_isopentenylaminomethyl_two_thiouridine	ZMAPSTYLE_MODE_BASIC	ZMAPHOMOL_NONE
five_isopentenylaminomethyl_two_prime_O_methyluridine	ZMAPSTYLE_MODE_BASIC	ZMAPHOMOL_NONE
histone_binding_site	ZMAPSTYLE_MODE_BASIC	ZMAPHOMOL_NONE
CDS_fragment	ZMAPSTYLE_MODE_BASIC	ZMAPHOMOL_NONE
modified_amino_acid_feature	ZMAPSTYLE_MODE_BASIC	ZMAPHOMOL_NONE
modified_glycine	ZMAPSTYLE_MODE_BASIC	ZMAPHOMOL_NONE
modified_L_alanine	ZMAPSTYLE_MODE_BASIC	ZMAPHOMOL_NONE
modified_L_asparagine	ZMAPSTYLE_MODE_BASIC	ZMAPHOMOL_NONE
modified_L_aspartic_acid	ZMAPSTYLE_MODE_BASIC	ZMAPHOMOL_NONE
modified_L_cysteine	ZMAPSTYLE_MODE_BASIC	ZMAPHOMOL_NONE
modified_L_glutamic_acid	ZMAPSTYLE_MODE_BASIC	ZMAPHOMOL_NONE
modified_L_threonine	ZMAPSTYLE_MODE_BASIC	ZMAPHOMOL_NONE
modified_L_tryptophan	ZMAPSTYLE_MODE_BASIC	ZMAPHOMOL_NONE
modified_L_glutamine	ZMAPSTYLE_MODE_BASIC	ZMAPHOMOL_NONE
modified_L_methionine	ZMAPSTYLE_MODE_BASIC	ZMAPHOMOL_NONE
modified_L_isoleucine	ZMAPSTYLE_MODE_BASIC	ZMAPHOMOL_NONE
modified_L_phenylalanine	ZMAPSTYLE_MODE_BASIC	ZMAPHOMOL_NONE
modified_L_histidine	ZMAPSTYLE_MODE_BASIC	ZMAPHOMOL_NONE
modified_L_serine	ZMAPSTYLE_MODE_BASIC	ZMAPHOMOL_NONE
modified_L_lysine	ZMAPSTYLE_MODE_BASIC	ZMAPHOMOL_NONE
modified_L_leucine	ZMAPSTYLE_MODE_BASIC	ZMAPHOMOL_NONE
modified_L_selenocysteine	ZMAPSTYLE_MODE_BASIC	ZMAPHOMOL_NONE
modified_L_valine	ZMAPSTYLE_MODE_BASIC	ZMAPHOMOL_NONE
modified_L_proline	ZMAPSTYLE_MODE_BASIC	ZMAPHOMOL_NONE
modified_L_tyrosine	ZMAPSTYLE_MODE_BASIC	ZMAPHOMOL_NONE
modified_L_arginine	ZMAPSTYLE_MODE_BASIC	ZMAPHOMOL_NONE
peptidyl	ZMAPSTYLE_MODE_BASIC	ZMAPHOMOL_NONE
cleaved_for_gpi_anchor_region	ZMAPSTYLE_MODE_BASIC	ZMAPHOMOL_NONE
biomaterial_region	ZMAPSTYLE_MODE_BASIC	ZMAPHOMOL_NONE
experimental_feature	ZMAPSTYLE_MODE_BASIC	ZMAPHOMOL_NONE
biological_region	ZMAPSTYLE_MODE_BASIC	ZMAPHOMOL_NONE
topologically_defined_region	ZMAPSTYLE_MODE_BASIC	ZMAPHOMOL_NONE
translocation_breakpoint	ZMAPSTYLE_MODE_BASIC	ZMAPHOMOL_NONE
insertion_breakpoint	ZMAPSTYLE_MODE_BASIC	ZMAPHOMOL_NONE
deletion_breakpoint	ZMAPSTYLE_MODE_BASIC	ZMAPHOMOL_NONE
five_prime_flanking_region	ZMAPSTYLE_MODE_BASIC	ZMAPHOMOL_NONE
three_prime_flanking_region	ZMAPSTYLE_MODE_BASIC	ZMAPHOMOL_NONE
transcribed_fragment	ZMAPSTYLE_MODE_BASIC	ZMAPHOMOL_NONE
cis_splice_site	ZMAPSTYLE_MODE_BASIC	ZMAPHOMOL_NONE
trans_splice_site	ZMAPSTYLE_MODE_BASIC	ZMAPHOMOL_NONE
splice_junction	ZMAPSTYLE_MODE_BASIC	ZMAPHOMOL_NONE
conformational_switch	ZMAPSTYLE_MODE_BASIC	ZMAPHOMOL_NONE
dye_terminator_read	ZMAPSTYLE_MODE_BASIC	ZMAPHOMOL_NONE
pyrosequenced_read	ZMAPSTYLE_MODE_BASIC	ZMAPHOMOL_NONE
ligation_based_read	ZMAPSTYLE_MODE_BASIC	ZMAPHOMOL_NONE
polymerase_synthesis_read	ZMAPSTYLE_MODE_BASIC	ZMAPHOMOL_NONE
cis_regulatory_frameshift_element	ZMAPSTYLE_MODE_BASIC	ZMAPHOMOL_NONE
expressed_sequence_assembly	ZMAPSTYLE_MODE_BASIC	ZMAPHOMOL_NONE
DNA_binding_site	ZMAPSTYLE_MODE_BASIC	ZMAPHOMOL_NONE
cryptic_gene	ZMAPSTYLE_MODE_BASIC	ZMAPHOMOL_NONE
three_prime_RACE_clone	ZMAPSTYLE_MODE_BASIC	ZMAPHOMOL_NONE
cassette_pseudogene	ZMAPSTYLE_MODE_BASIC	ZMAPHOMOL_NONE
alanine	ZMAPSTYLE_MODE_BASIC	ZMAPHOMOL_NONE
valine	ZMAPSTYLE_MODE_BASIC	ZMAPHOMOL_NONE
leucine	ZMAPSTYLE_MODE_BASIC	ZMAPHOMOL_NONE
isoleucine	ZMAPSTYLE_MODE_BASIC	ZMAPHOMOL_NONE
proline	ZMAPSTYLE_MODE_BASIC	ZMAPHOMOL_NONE
tryptophan	ZMAPSTYLE_MODE_BASIC	ZMAPHOMOL_NONE
phenylalanine	ZMAPSTYLE_MODE_BASIC	ZMAPHOMOL_NONE
methionine	ZMAPSTYLE_MODE_BASIC	ZMAPHOMOL_NONE
glycine	ZMAPSTYLE_MODE_BASIC	ZMAPHOMOL_NONE
serine	ZMAPSTYLE_MODE_BASIC	ZMAPHOMOL_NONE
threonine	ZMAPSTYLE_MODE_BASIC	ZMAPHOMOL_NONE
tyrosine	ZMAPSTYLE_MODE_BASIC	ZMAPHOMOL_NONE
cysteine	ZMAPSTYLE_MODE_BASIC	ZMAPHOMOL_NONE
glutamine	ZMAPSTYLE_MODE_BASIC	ZMAPHOMOL_NONE
asparagine	ZMAPSTYLE_MODE_BASIC	ZMAPHOMOL_NONE
lysine	ZMAPSTYLE_MODE_BASIC	ZMAPHOMOL_NONE
arginine	ZMAPSTYLE_MODE_BASIC	ZMAPHOMOL_NONE
histidine	ZMAPSTYLE_MODE_BASIC	ZMAPHOMOL_NONE
aspartic_acid	ZMAPSTYLE_MODE_BASIC	ZMAPHOMOL_NONE
glutamic_acid	ZMAPSTYLE_MODE_BASIC	ZMAPHOMOL_NONE
selenocysteine	ZMAPSTYLE_MODE_BASIC	ZMAPHOMOL_NONE
pyrrolysine	ZMAPSTYLE_MODE_BASIC	ZMAPHOMOL_NONE
transcribed_cluster	ZMAPSTYLE_MODE_BASIC	ZMAPHOMOL_NONE
unigene_cluster	ZMAPSTYLE_MODE_BASIC	ZMAPHOMOL_NONE
CRISPR	ZMAPSTYLE_MODE_BASIC	ZMAPHOMOL_NONE
insulator_binding_site	ZMAPSTYLE_MODE_BASIC	ZMAPHOMOL_NONE
enhancer_binding_site	ZMAPSTYLE_MODE_BASIC	ZMAPHOMOL_NONE
contig_collection	ZMAPSTYLE_MODE_BASIC	ZMAPHOMOL_NONE
lincRNA	ZMAPSTYLE_MODE_BASIC	ZMAPHOMOL_NONE
UST	ZMAPSTYLE_MODE_BASIC	ZMAPHOMOL_NONE
three_prime_UST	ZMAPSTYLE_MODE_BASIC	ZMAPHOMOL_NONE
five_prime_UST	ZMAPSTYLE_MODE_BASIC	ZMAPHOMOL_NONE
RST	ZMAPSTYLE_MODE_BASIC	ZMAPHOMOL_NONE
three_prime_RST	ZMAPSTYLE_MODE_BASIC	ZMAPHOMOL_NONE
five_prime_RST	ZMAPSTYLE_MODE_BASIC	ZMAPHOMOL_NONE
UST_match	ZMAPSTYLE_MODE_ALIGNMENT	ZMAPHOMOL_NONE
RST_match	ZMAPSTYLE_MODE_ALIGNMENT	ZMAPHOMOL_NONE
primer_match	ZMAPSTYLE_MODE_ALIGNMENT	ZMAPHOMOL_NONE
miRNA_antiguide	ZMAPSTYLE_MODE_BASIC	ZMAPHOMOL_NONE
trans_splice_junction	ZMAPSTYLE_MODE_BASIC	ZMAPHOMOL_NONE
outron	ZMAPSTYLE_MODE_BASIC	ZMAPHOMOL_NONE
natural_plasmid	ZMAPSTYLE_MODE_BASIC	ZMAPHOMOL_NONE
gene_trap_construct	ZMAPSTYLE_MODE_BASIC	ZMAPHOMOL_NONE
promoter_trap_construct	ZMAPSTYLE_MODE_BASIC	ZMAPHOMOL_NONE
enhancer_trap_construct	ZMAPSTYLE_MODE_BASIC	ZMAPHOMOL_NONE
PAC_end	ZMAPSTYLE_MODE_BASIC	ZMAPHOMOL_NONE
RAPD	ZMAPSTYLE_MODE_BASIC	ZMAPHOMOL_NONE
shadow_enhancer	ZMAPSTYLE_MODE_BASIC	ZMAPHOMOL_NONE
SNV	ZMAPSTYLE_MODE_BASIC	ZMAPHOMOL_NONE
X_element_combinatorial_repeat	ZMAPSTYLE_MODE_BASIC	ZMAPHOMOL_NONE
Y_prime_element	ZMAPSTYLE_MODE_BASIC	ZMAPHOMOL_NONE
standard_draft	ZMAPSTYLE_MODE_BASIC	ZMAPHOMOL_NONE
high_quality_draft	ZMAPSTYLE_MODE_BASIC	ZMAPHOMOL_NONE
improved_high_quality_draft	ZMAPSTYLE_MODE_BASIC	ZMAPHOMOL_NONE
annotation_directed_improved_draft	ZMAPSTYLE_MODE_BASIC	ZMAPHOMOL_NONE
noncontiguous_finished	ZMAPSTYLE_MODE_BASIC	ZMAPHOMOL_NONE
finished_genome	ZMAPSTYLE_MODE_BASIC	ZMAPHOMOL_NONE
intronic_regulatory_region	ZMAPSTYLE_MODE_BASIC	ZMAPHOMOL_NONE
centromere_DNA_Element_I	ZMAPSTYLE_MODE_BASIC	ZMAPHOMOL_NONE
centromere_DNA_Element_II	ZMAPSTYLE_MODE_BASIC	ZMAPHOMOL_NONE
centromere_DNA_Element_III	ZMAPSTYLE_MODE_BASIC	ZMAPHOMOL_NONE
telomeric_repeat	ZMAPSTYLE_MODE_BASIC	ZMAPHOMOL_NONE
X_element	ZMAPSTYLE_MODE_BASIC	ZMAPHOMOL_NONE
YAC_end	ZMAPSTYLE_MODE_BASIC	ZMAPHOMOL_NONE
whole_genome_sequence_status	ZMAPSTYLE_MODE_BASIC	ZMAPHOMOL_NONE
heritable_phenotypic_marker	ZMAPSTYLE_MODE_BASIC	ZMAPHOMOL_NONE
peptide_collection	ZMAPSTYLE_MODE_BASIC	ZMAPHOMOL_NONE
high_identity_region	ZMAPSTYLE_MODE_BASIC	ZMAPHOMOL_NONE
processed_transcript	ZMAPSTYLE_MODE_TRANSCRIPT	ZMAPHOMOL_NONE
assortment_derived_variation	ZMAPSTYLE_MODE_BASIC	ZMAPHOMOL_NONE
reference_genome	ZMAPSTYLE_MODE_BASIC	ZMAPHOMOL_NONE
variant_genome	ZMAPSTYLE_MODE_BASIC	ZMAPHOMOL_NONE
variant_collection	ZMAPSTYLE_MODE_BASIC	ZMAPHOMOL_NONE
alteration_attribute	ZMAPSTYLE_MODE_BASIC	ZMAPHOMOL_NONE
chromosomal_variation_attribute	ZMAPSTYLE_MODE_BASIC	ZMAPHOMOL_NONE
intrachromosomal	ZMAPSTYLE_MODE_BASIC	ZMAPHOMOL_NONE
interchromosomal	ZMAPSTYLE_MODE_BASIC	ZMAPHOMOL_NONE
insertion_attribute	ZMAPSTYLE_MODE_BASIC	ZMAPHOMOL_NONE
tandem	ZMAPSTYLE_MODE_BASIC	ZMAPHOMOL_NONE
direct	ZMAPSTYLE_MODE_BASIC	ZMAPHOMOL_NONE
inverted	ZMAPSTYLE_MODE_BASIC	ZMAPHOMOL_NONE
free	ZMAPSTYLE_MODE_BASIC	ZMAPHOMOL_NONE
inversion_attribute	ZMAPSTYLE_MODE_BASIC	ZMAPHOMOL_NONE
pericentric	ZMAPSTYLE_MODE_BASIC	ZMAPHOMOL_NONE
paracentric	ZMAPSTYLE_MODE_BASIC	ZMAPHOMOL_NONE
translocaton_attribute	ZMAPSTYLE_MODE_BASIC	ZMAPHOMOL_NONE
reciprocal	ZMAPSTYLE_MODE_BASIC	ZMAPHOMOL_NONE
insertional	ZMAPSTYLE_MODE_BASIC	ZMAPHOMOL_NONE
duplication_attribute	ZMAPSTYLE_MODE_BASIC	ZMAPHOMOL_NONE
chromosomally_aberrant_genome	ZMAPSTYLE_MODE_BASIC	ZMAPHOMOL_NONE
assembly_error_correction	ZMAPSTYLE_MODE_BASIC	ZMAPHOMOL_NONE
base_call_error_correction	ZMAPSTYLE_MODE_BASIC	ZMAPHOMOL_NONE
peptide_localization_signal	ZMAPSTYLE_MODE_BASIC	ZMAPHOMOL_NONE
nuclear_localization_signal	ZMAPSTYLE_MODE_BASIC	ZMAPHOMOL_NONE
endosomal_localization_signal	ZMAPSTYLE_MODE_BASIC	ZMAPHOMOL_NONE
lysosomal_localization_signal	ZMAPSTYLE_MODE_BASIC	ZMAPHOMOL_NONE
nuclear_export_signal	ZMAPSTYLE_MODE_BASIC	ZMAPHOMOL_NONE
recombination_signal_sequence	ZMAPSTYLE_MODE_BASIC	ZMAPHOMOL_NONE
cryptic_splice_site	ZMAPSTYLE_MODE_BASIC	ZMAPHOMOL_NONE
nuclear_rim_localization_signal	ZMAPSTYLE_MODE_BASIC	ZMAPHOMOL_NONE
p_element	ZMAPSTYLE_MODE_BASIC	ZMAPHOMOL_NONE
functional_variant	ZMAPSTYLE_MODE_BASIC	ZMAPHOMOL_NONE
structural_variant	ZMAPSTYLE_MODE_BASIC	ZMAPHOMOL_NONE
transcript_function_variant	ZMAPSTYLE_MODE_BASIC	ZMAPHOMOL_NONE
translational_product_function_variant	ZMAPSTYLE_MODE_BASIC	ZMAPHOMOL_NONE
level_of_transcript_variant	ZMAPSTYLE_MODE_TRANSCRIPT	ZMAPHOMOL_NONE
decreased_transcript_level_variant	ZMAPSTYLE_MODE_TRANSCRIPT	ZMAPHOMOL_NONE
increased_transcript_level_variant	ZMAPSTYLE_MODE_TRANSCRIPT	ZMAPHOMOL_NONE
transcript_processing_variant	ZMAPSTYLE_MODE_BASIC	ZMAPHOMOL_NONE
editing_variant	ZMAPSTYLE_MODE_BASIC	ZMAPHOMOL_NONE
polyadenylation_variant	ZMAPSTYLE_MODE_BASIC	ZMAPHOMOL_NONE
transcript_stability_variant	ZMAPSTYLE_MODE_BASIC	ZMAPHOMOL_NONE
decreased_transcript_stability_variant	ZMAPSTYLE_MODE_TRANSCRIPT	ZMAPHOMOL_NONE
increased_transcript_stability_variant	ZMAPSTYLE_MODE_TRANSCRIPT	ZMAPHOMOL_NONE
transcription_variant	ZMAPSTYLE_MODE_BASIC	ZMAPHOMOL_NONE
rate_of_transcription_variant	ZMAPSTYLE_MODE_TRANSCRIPT	ZMAPHOMOL_NONE
increased_transcription_rate_variant	ZMAPSTYLE_MODE_TRANSCRIPT	ZMAPHOMOL_NONE
decreased_transcription_rate_variant	ZMAPSTYLE_MODE_TRANSCRIPT	ZMAPHOMOL_NONE
translational_product_level_variant	ZMAPSTYLE_MODE_BASIC	ZMAPHOMOL_NONE
polypeptide_function_variant	ZMAPSTYLE_MODE_BASIC	ZMAPHOMOL_NONE
decreased_translational_product_level	ZMAPSTYLE_MODE_BASIC	ZMAPHOMOL_NONE
increased_translational_product_level	ZMAPSTYLE_MODE_BASIC	ZMAPHOMOL_NONE
polypeptide_gain_of_function_variant	ZMAPSTYLE_MODE_BASIC	ZMAPHOMOL_NONE
polypeptide_localization_variant	ZMAPSTYLE_MODE_BASIC	ZMAPHOMOL_NONE
polypeptide_loss_of_function_variant	ZMAPSTYLE_MODE_BASIC	ZMAPHOMOL_NONE
inactive_ligand_binding_site	ZMAPSTYLE_MODE_BASIC	ZMAPHOMOL_NONE
polypeptide_partial_loss_of_function	ZMAPSTYLE_MODE_BASIC	ZMAPHOMOL_NONE
polypeptide_post_translational_processing_variant	ZMAPSTYLE_MODE_BASIC	ZMAPHOMOL_NONE
copy_number_change	ZMAPSTYLE_MODE_BASIC	ZMAPHOMOL_NONE
gene_variant	ZMAPSTYLE_MODE_BASIC	ZMAPHOMOL_NONE
gene_fusion	ZMAPSTYLE_MODE_BASIC	ZMAPHOMOL_NONE
regulatory_region_variant	ZMAPSTYLE_MODE_BASIC	ZMAPHOMOL_NONE
stop_retained_variant	ZMAPSTYLE_MODE_BASIC	ZMAPHOMOL_NONE
splicing_variant	ZMAPSTYLE_MODE_BASIC	ZMAPHOMOL_NONE
cryptic_splice_site_variant	ZMAPSTYLE_MODE_BASIC	ZMAPHOMOL_NONE
cryptic_splice_acceptor	ZMAPSTYLE_MODE_BASIC	ZMAPHOMOL_NONE
cryptic_splice_donor	ZMAPSTYLE_MODE_BASIC	ZMAPHOMOL_NONE
exon_loss_variant	ZMAPSTYLE_MODE_BASIC	ZMAPHOMOL_NONE
intron_gain	ZMAPSTYLE_MODE_BASIC	ZMAPHOMOL_NONE
splice_acceptor_variant	ZMAPSTYLE_MODE_BASIC	ZMAPHOMOL_NONE
splice_donor_variant	ZMAPSTYLE_MODE_BASIC	ZMAPHOMOL_NONE
transcript_variant	ZMAPSTYLE_MODE_BASIC	ZMAPHOMOL_NONE
complex_transcript_variant	ZMAPSTYLE_MODE_TRANSCRIPT	ZMAPHOMOL_NONE
stop_lost	ZMAPSTYLE_MODE_BASIC	ZMAPHOMOL_NONE
coding_sequence_variant	ZMAPSTYLE_MODE_BASIC	ZMAPHOMOL_NONE
initiator_codon_variant	ZMAPSTYLE_MODE_BASIC	ZMAPHOMOL_NONE
missense_variant	ZMAPSTYLE_MODE_BASIC	ZMAPHOMOL_NONE
conservative_missense_variant	ZMAPSTYLE_MODE_BASIC	ZMAPHOMOL_NONE
non_conservative_missense_variant	ZMAPSTYLE_MODE_BASIC	ZMAPHOMOL_NONE
stop_gained	ZMAPSTYLE_MODE_BASIC	ZMAPHOMOL_NONE
frameshift_variant	ZMAPSTYLE_MODE_BASIC	ZMAPHOMOL_NONE
terminator_codon_variant	ZMAPSTYLE_MODE_BASIC	ZMAPHOMOL_NONE
frame_restoring_variant	ZMAPSTYLE_MODE_BASIC	ZMAPHOMOL_NONE
minus_1_frameshift_variant	ZMAPSTYLE_MODE_BASIC	ZMAPHOMOL_NONE
minus_2_frameshift_variant	ZMAPSTYLE_MODE_BASIC	ZMAPHOMOL_NONE
plus_1_frameshift_variant	ZMAPSTYLE_MODE_BASIC	ZMAPHOMOL_NONE
plus_2_frameshift_variant	ZMAPSTYLE_MODE_BASIC	ZMAPHOMOL_NONE
transcript_secondary_structure_variant	ZMAPSTYLE_MODE_BASIC	ZMAPHOMOL_NONE
compensatory_transcript_secondary_structure_variant	ZMAPSTYLE_MODE_TRANSCRIPT	ZMAPHOMOL_NONE
translational_product_structure_variant	ZMAPSTYLE_MODE_BASIC	ZMAPHOMOL_NONE
3D_polypeptide_structure_variant	ZMAPSTYLE_MODE_BASIC	ZMAPHOMOL_NONE
complex_3D_structural_variant	ZMAPSTYLE_MODE_BASIC	ZMAPHOMOL_NONE
conformational_change_variant	ZMAPSTYLE_MODE_BASIC	ZMAPHOMOL_NONE
complex_change_of_translational_product_variant	ZMAPSTYLE_MODE_BASIC	ZMAPHOMOL_NONE
polypeptide_sequence_variant	ZMAPSTYLE_MODE_BASIC	ZMAPHOMOL_NONE
amino_acid_deletion	ZMAPSTYLE_MODE_BASIC	ZMAPHOMOL_NONE
amino_acid_insertion	ZMAPSTYLE_MODE_BASIC	ZMAPHOMOL_NONE
amino_acid_substitution	ZMAPSTYLE_MODE_BASIC	ZMAPHOMOL_NONE
conservative_amino_acid_substitution	ZMAPSTYLE_MODE_BASIC	ZMAPHOMOL_NONE
non_conservative_amino_acid_substitution	ZMAPSTYLE_MODE_BASIC	ZMAPHOMOL_NONE
elongated_polypeptide	ZMAPSTYLE_MODE_BASIC	ZMAPHOMOL_NONE
elongated_polypeptide_C_terminal	ZMAPSTYLE_MODE_BASIC	ZMAPHOMOL_NONE
elongated_polypeptide_N_terminal	ZMAPSTYLE_MODE_BASIC	ZMAPHOMOL_NONE
elongated_in_frame_polypeptide_C_terminal	ZMAPSTYLE_MODE_BASIC	ZMAPHOMOL_NONE
elongated_out_of_frame_polypeptide_C_terminal	ZMAPSTYLE_MODE_BASIC	ZMAPHOMOL_NONE
elongated_in_frame_polypeptide_N_terminal_elongation	ZMAPSTYLE_MODE_BASIC	ZMAPHOMOL_NONE
elongated_out_of_frame_polypeptide_N_terminal	ZMAPSTYLE_MODE_BASIC	ZMAPHOMOL_NONE
polypeptide_fusion	ZMAPSTYLE_MODE_BASIC	ZMAPHOMOL_NONE
polypeptide_truncation	ZMAPSTYLE_MODE_BASIC	ZMAPHOMOL_NONE
inactive_catalytic_site	ZMAPSTYLE_MODE_BASIC	ZMAPHOMOL_NONE
non_coding_transcript_variant	ZMAPSTYLE_MODE_TRANSCRIPT	ZMAPHOMOL_NONE
mature_miRNA_variant	ZMAPSTYLE_MODE_BASIC	ZMAPHOMOL_NONE
NMD_transcript_variant	ZMAPSTYLE_MODE_TRANSCRIPT	ZMAPHOMOL_NONE
UTR_variant	ZMAPSTYLE_MODE_BASIC	ZMAPHOMOL_NONE
5_prime_UTR_variant	ZMAPSTYLE_MODE_BASIC	ZMAPHOMOL_NONE
3_prime_UTR_variant	ZMAPSTYLE_MODE_BASIC	ZMAPHOMOL_NONE
incomplete_terminal_codon_variant	ZMAPSTYLE_MODE_BASIC	ZMAPHOMOL_NONE
intron_variant	ZMAPSTYLE_MODE_BASIC	ZMAPHOMOL_NONE
intergenic_variant	ZMAPSTYLE_MODE_BASIC	ZMAPHOMOL_NONE
splice_site_variant	ZMAPSTYLE_MODE_BASIC	ZMAPHOMOL_NONE
splice_region_variant	ZMAPSTYLE_MODE_BASIC	ZMAPHOMOL_NONE
upstream_gene_variant	ZMAPSTYLE_MODE_BASIC	ZMAPHOMOL_NONE
downstream_gene_variant	ZMAPSTYLE_MODE_BASIC	ZMAPHOMOL_NONE
5KB_downstream_variant	ZMAPSTYLE_MODE_BASIC	ZMAPHOMOL_NONE
500B_downstream_variant	ZMAPSTYLE_MODE_BASIC	ZMAPHOMOL_NONE
5KB_upstream_variant	ZMAPSTYLE_MODE_BASIC	ZMAPHOMOL_NONE
2KB_upstream_variant	ZMAPSTYLE_MODE_BASIC	ZMAPHOMOL_NONE
rRNA_gene	ZMAPSTYLE_MODE_BASIC	ZMAPHOMOL_NONE
piRNA_gene	ZMAPSTYLE_MODE_BASIC	ZMAPHOMOL_NONE
RNase_P_RNA_gene	ZMAPSTYLE_MODE_BASIC	ZMAPHOMOL_NONE
RNase_MRP_RNA_gene	ZMAPSTYLE_MODE_BASIC	ZMAPHOMOL_NONE
lincRNA_gene	ZMAPSTYLE_MODE_BASIC	ZMAPHOMOL_NONE
mathematically_defined_repeat	ZMAPSTYLE_MODE_BASIC	ZMAPHOMOL_NONE
telomerase_RNA_gene	ZMAPSTYLE_MODE_BASIC	ZMAPHOMOL_NONE
targeting_vector	ZMAPSTYLE_MODE_BASIC	ZMAPHOMOL_NONE
genetic_marker	ZMAPSTYLE_MODE_BASIC	ZMAPHOMOL_NONE
DArT_marker	ZMAPSTYLE_MODE_BASIC	ZMAPHOMOL_NONE
kozak_sequence	ZMAPSTYLE_MODE_BASIC	ZMAPHOMOL_NONE
nested_transposon	ZMAPSTYLE_MODE_BASIC	ZMAPHOMOL_NONE
nested_repeat	ZMAPSTYLE_MODE_BASIC	ZMAPHOMOL_NONE
inframe_variant	ZMAPSTYLE_MODE_BASIC	ZMAPHOMOL_NONE
retinoic_acid_responsive_element	ZMAPSTYLE_MODE_BASIC	ZMAPHOMOL_NONE
nucleotide_to_protein_binding_site	ZMAPSTYLE_MODE_BASIC	ZMAPHOMOL_NONE
nucleotide_binding_site	ZMAPSTYLE_MODE_BASIC	ZMAPHOMOL_NONE
metal_binding_site	ZMAPSTYLE_MODE_BASIC	ZMAPHOMOL_NONE
ligand_binding_site	ZMAPSTYLE_MODE_BASIC	ZMAPHOMOL_NONE
nested_tandem_repeat	ZMAPSTYLE_MODE_BASIC	ZMAPHOMOL_NONE
promoter_element	ZMAPSTYLE_MODE_BASIC	ZMAPHOMOL_NONE
core_promoter_element	ZMAPSTYLE_MODE_BASIC	ZMAPHOMOL_NONE
RNA_polymerase_II_TATA_box	ZMAPSTYLE_MODE_BASIC	ZMAPHOMOL_NONE
RNA_polymerase_III_TATA_box	ZMAPSTYLE_MODE_BASIC	ZMAPHOMOL_NONE
BREd_motif	ZMAPSTYLE_MODE_BASIC	ZMAPHOMOL_NONE
DCE	ZMAPSTYLE_MODE_BASIC	ZMAPHOMOL_NONE
DCE_SI	ZMAPSTYLE_MODE_BASIC	ZMAPHOMOL_NONE
DCE_SII	ZMAPSTYLE_MODE_BASIC	ZMAPHOMOL_NONE
DCE_SIII	ZMAPSTYLE_MODE_BASIC	ZMAPHOMOL_NONE
proximal_promoter_element	ZMAPSTYLE_MODE_BASIC	ZMAPHOMOL_NONE
RNApol_II_core_promoter	ZMAPSTYLE_MODE_BASIC	ZMAPHOMOL_NONE
distal_promoter_element	ZMAPSTYLE_MODE_BASIC	ZMAPHOMOL_NONE
bacterial_RNApol_promoter_sigma_70	ZMAPSTYLE_MODE_BASIC	ZMAPHOMOL_NONE
bacterial_RNApol_promoter_sigma54	ZMAPSTYLE_MODE_BASIC	ZMAPHOMOL_NONE
minus_12_signal	ZMAPSTYLE_MODE_BASIC	ZMAPHOMOL_NONE
minus_24_signal	ZMAPSTYLE_MODE_BASIC	ZMAPHOMOL_NONE
A_box_type_1	ZMAPSTYLE_MODE_BASIC	ZMAPHOMOL_NONE
A_box_type_2	ZMAPSTYLE_MODE_BASIC	ZMAPHOMOL_NONE
intermediate_element	ZMAPSTYLE_MODE_BASIC	ZMAPHOMOL_NONE
regulatory_promoter_element	ZMAPSTYLE_MODE_BASIC	ZMAPHOMOL_NONE
transcription_regulatory_region	ZMAPSTYLE_MODE_BASIC	ZMAPHOMOL_NONE
translation_regulatory_region	ZMAPSTYLE_MODE_BASIC	ZMAPHOMOL_NONE
recombination_regulatory_region	ZMAPSTYLE_MODE_BASIC	ZMAPHOMOL_NONE
replication_regulatory_region	ZMAPSTYLE_MODE_BASIC	ZMAPHOMOL_NONE
sequence_motif	ZMAPSTYLE_MODE_BASIC	ZMAPHOMOL_NONE
experimental_feature_attribute	ZMAPSTYLE_MODE_BASIC	ZMAPHOMOL_NONE
score	ZMAPSTYLE_MODE_BASIC	ZMAPHOMOL_NONE
quality_value	ZMAPSTYLE_MODE_BASIC	ZMAPHOMOL_NONE
restriction_enzyme_recognition_site	ZMAPSTYLE_MODE_BASIC	ZMAPHOMOL_NONE
restriction_enzyme_cleavage_junction	ZMAPSTYLE_MODE_BASIC	ZMAPHOMOL_NONE
five_prime_restriction_enzyme_junction	ZMAPSTYLE_MODE_BASIC	ZMAPHOMOL_NONE
three_prime_restriction_enzyme_junction	ZMAPSTYLE_MODE_BASIC	ZMAPHOMOL_NONE
blunt_end_restriction_enzyme_cleavage_site	ZMAPSTYLE_MODE_BASIC	ZMAPHOMOL_NONE
sticky_end_restriction_enzyme_cleavage_site	ZMAPSTYLE_MODE_BASIC	ZMAPHOMOL_NONE
blunt_end_restriction_enzyme_cleavage_junction	ZMAPSTYLE_MODE_BASIC	ZMAPHOMOL_NONE
single_strand_restriction_enzyme_cleavage_site	ZMAPSTYLE_MODE_BASIC	ZMAPHOMOL_NONE
restriction_enzyme_single_strand_overhang	ZMAPSTYLE_MODE_BASIC	ZMAPHOMOL_NONE
experimentally_defined_binding_region	ZMAPSTYLE_MODE_BASIC	ZMAPHOMOL_NONE
ChIP_seq_region	ZMAPSTYLE_MODE_BASIC	ZMAPHOMOL_NONE
ASPE_primer	ZMAPSTYLE_MODE_BASIC	ZMAPHOMOL_NONE
dCAPS_primer	ZMAPSTYLE_MODE_BASIC	ZMAPHOMOL_NONE
histone_modification	ZMAPSTYLE_MODE_BASIC	ZMAPHOMOL_NONE
histone_methylation_site	ZMAPSTYLE_MODE_BASIC	ZMAPHOMOL_NONE
histone_acetylation_site	ZMAPSTYLE_MODE_BASIC	ZMAPHOMOL_NONE
H3K9_acetylation_site	ZMAPSTYLE_MODE_BASIC	ZMAPHOMOL_NONE
H3K14_acetylation_site	ZMAPSTYLE_MODE_BASIC	ZMAPHOMOL_NONE
H3K4_monomethylation_site	ZMAPSTYLE_MODE_BASIC	ZMAPHOMOL_NONE
H3K4_trimethylation	ZMAPSTYLE_MODE_BASIC	ZMAPHOMOL_NONE
H3K9_trimethylation_site	ZMAPSTYLE_MODE_BASIC	ZMAPHOMOL_NONE
H3K27_monomethylation_site	ZMAPSTYLE_MODE_BASIC	ZMAPHOMOL_NONE
H3K27_trimethylation_site	ZMAPSTYLE_MODE_BASIC	ZMAPHOMOL_NONE
H3K79_monomethylation_site	ZMAPSTYLE_MODE_BASIC	ZMAPHOMOL_NONE
H3K79_dimethylation_site	ZMAPSTYLE_MODE_BASIC	ZMAPHOMOL_NONE
H3K79_trimethylation_site	ZMAPSTYLE_MODE_BASIC	ZMAPHOMOL_NONE
H4K20_monomethylation_site	ZMAPSTYLE_MODE_BASIC	ZMAPHOMOL_NONE
H2BK5_monomethylation_site	ZMAPSTYLE_MODE_BASIC	ZMAPHOMOL_NONE
ISRE	ZMAPSTYLE_MODE_BASIC	ZMAPHOMOL_NONE
histone_ubiqitination_site	ZMAPSTYLE_MODE_BASIC	ZMAPHOMOL_NONE
H2B_ubiquitination_site	ZMAPSTYLE_MODE_BASIC	ZMAPHOMOL_NONE
H3K18_acetylation_site	ZMAPSTYLE_MODE_BASIC	ZMAPHOMOL_NONE
H3K23_acylation_site	ZMAPSTYLE_MODE_BASIC	ZMAPHOMOL_NONE
epigenetically_modified_region	ZMAPSTYLE_MODE_BASIC	ZMAPHOMOL_NONE
H3K27_acylation_site	ZMAPSTYLE_MODE_BASIC	ZMAPHOMOL_NONE
H3K36_monomethylation_site	ZMAPSTYLE_MODE_BASIC	ZMAPHOMOL_NONE
H3K36_dimethylation_site	ZMAPSTYLE_MODE_BASIC	ZMAPHOMOL_NONE
H3K36_trimethylation_site	ZMAPSTYLE_MODE_BASIC	ZMAPHOMOL_NONE
H3K4_dimethylation_site	ZMAPSTYLE_MODE_BASIC	ZMAPHOMOL_NONE
H3K27_dimethylation_site	ZMAPSTYLE_MODE_BASIC	ZMAPHOMOL_NONE
H3K9_monomethylation_site	ZMAPSTYLE_MODE_BASIC	ZMAPHOMOL_NONE
H3K9_dimethylation_site	ZMAPSTYLE_MODE_BASIC	ZMAPHOMOL_NONE
H4K16_acylation_site	ZMAPSTYLE_MODE_BASIC	ZMAPHOMOL_NONE
H4K5_acylation_site	ZMAPSTYLE_MODE_BASIC	ZMAPHOMOL_NONE
H4K8_acylation_site	ZMAPSTYLE_MODE_BASIC	ZMAPHOMOL_NONE
H3K27_methylation_site	ZMAPSTYLE_MODE_BASIC	ZMAPHOMOL_NONE
H3K36_methylation_site	ZMAPSTYLE_MODE_BASIC	ZMAPHOMOL_NONE
H3K4_methylation_site	ZMAPSTYLE_MODE_BASIC	ZMAPHOMOL_NONE
H3K79_methylation_site	ZMAPSTYLE_MODE_BASIC	ZMAPHOMOL_NONE
H3K9_methylation_site	ZMAPSTYLE_MODE_BASIC	ZMAPHOMOL_NONE
histone_acylation_region	ZMAPSTYLE_MODE_BASIC	ZMAPHOMOL_NONE
H4K_acylation_region	ZMAPSTYLE_MODE_BASIC	ZMAPHOMOL_NONE
gene_with_non_canonical_start_codon	ZMAPSTYLE_MODE_BASIC	ZMAPHOMOL_NONE
gene_with_start_codon_CUG	ZMAPSTYLE_MODE_BASIC	ZMAPHOMOL_NONE
pseudogenic_gene_segment	ZMAPSTYLE_MODE_BASIC	ZMAPHOMOL_NONE
copy_number_gain	ZMAPSTYLE_MODE_BASIC	ZMAPHOMOL_NONE
copy_number_loss	ZMAPSTYLE_MODE_BASIC	ZMAPHOMOL_NONE
UPD	ZMAPSTYLE_MODE_BASIC	ZMAPHOMOL_NONE
maternal_uniparental_disomy	ZMAPSTYLE_MODE_BASIC	ZMAPHOMOL_NONE
paternal_uniparental_disomy	ZMAPSTYLE_MODE_BASIC	ZMAPHOMOL_NONE
open_chromatin_region	ZMAPSTYLE_MODE_BASIC	ZMAPHOMOL_NONE
SL3_acceptor_site	ZMAPSTYLE_MODE_BASIC	ZMAPHOMOL_NONE
SL4_acceptor_site	ZMAPSTYLE_MODE_BASIC	ZMAPHOMOL_NONE
SL5_acceptor_site	ZMAPSTYLE_MODE_BASIC	ZMAPHOMOL_NONE
SL6_acceptor_site	ZMAPSTYLE_MODE_BASIC	ZMAPHOMOL_NONE
SL7_acceptor_site	ZMAPSTYLE_MODE_BASIC	ZMAPHOMOL_NONE
SL8_acceptor_site	ZMAPSTYLE_MODE_BASIC	ZMAPHOMOL_NONE
SL9_acceptor_site	ZMAPSTYLE_MODE_BASIC	ZMAPHOMOL_NONE
SL10_acceptor_site	ZMAPSTYLE_MODE_BASIC	ZMAPHOMOL_NONE
SL11_acceptor_site	ZMAPSTYLE_MODE_BASIC	ZMAPHOMOL_NONE
SL12_acceptor_site	ZMAPSTYLE_MODE_BASIC	ZMAPHOMOL_NONE
duplicated_pseudogene	ZMAPSTYLE_MODE_BASIC	ZMAPHOMOL_NONE
unitary_pseudogene	ZMAPSTYLE_MODE_BASIC	ZMAPHOMOL_NONE
non_processed_pseudogene	ZMAPSTYLE_MODE_BASIC	ZMAPHOMOL_NONE
variant_quality	ZMAPSTYLE_MODE_BASIC	ZMAPHOMOL_NONE
variant_origin	ZMAPSTYLE_MODE_BASIC	ZMAPHOMOL_NONE
variant_frequency	ZMAPSTYLE_MODE_BASIC	ZMAPHOMOL_NONE
unique_variant	ZMAPSTYLE_MODE_BASIC	ZMAPHOMOL_NONE
rare_variant	ZMAPSTYLE_MODE_BASIC	ZMAPHOMOL_NONE
polymorphic_variant	ZMAPSTYLE_MODE_BASIC	ZMAPHOMOL_NONE
common_variant	ZMAPSTYLE_MODE_BASIC	ZMAPHOMOL_NONE
fixed_variant	ZMAPSTYLE_MODE_BASIC	ZMAPHOMOL_NONE
variant_phenotype	ZMAPSTYLE_MODE_BASIC	ZMAPHOMOL_NONE
benign_variant	ZMAPSTYLE_MODE_BASIC	ZMAPHOMOL_NONE
disease_associated_variant	ZMAPSTYLE_MODE_BASIC	ZMAPHOMOL_NONE
disease_causing_variant	ZMAPSTYLE_MODE_BASIC	ZMAPHOMOL_NONE
lethal_variant	ZMAPSTYLE_MODE_BASIC	ZMAPHOMOL_NONE
quantitative_variant	ZMAPSTYLE_MODE_BASIC	ZMAPHOMOL_NONE
maternal_variant	ZMAPSTYLE_MODE_BASIC	ZMAPHOMOL_NONE
paternal_variant	ZMAPSTYLE_MODE_BASIC	ZMAPHOMOL_NONE
somatic_variant	ZMAPSTYLE_MODE_BASIC	ZMAPHOMOL_NONE
germline_variant	ZMAPSTYLE_MODE_BASIC	ZMAPHOMOL_NONE
pedigree_specific_variant	ZMAPSTYLE_MODE_BASIC	ZMAPHOMOL_NONE
population_specific_variant	ZMAPSTYLE_MODE_BASIC	ZMAPHOMOL_NONE
de_novo_variant	ZMAPSTYLE_MODE_BASIC	ZMAPHOMOL_NONE
TF_binding_site_variant	ZMAPSTYLE_MODE_BASIC	ZMAPHOMOL_NONE
complex_structural_alteration	ZMAPSTYLE_MODE_BASIC	ZMAPHOMOL_NONE
structural_alteration	ZMAPSTYLE_MODE_BASIC	ZMAPHOMOL_NONE
loss_of_heterozygosity	ZMAPSTYLE_MODE_BASIC	ZMAPHOMOL_NONE
splice_donor_5th_base_variant	ZMAPSTYLE_MODE_BASIC	ZMAPHOMOL_NONE
U_box	ZMAPSTYLE_MODE_BASIC	ZMAPHOMOL_NONE
mating_type_region	ZMAPSTYLE_MODE_BASIC	ZMAPHOMOL_NONE
paired_end_fragment	ZMAPSTYLE_MODE_BASIC	ZMAPHOMOL_NONE
exon_variant	ZMAPSTYLE_MODE_BASIC	ZMAPHOMOL_NONE
non_coding_transcript_exon_variant	ZMAPSTYLE_MODE_TRANSCRIPT	ZMAPHOMOL_NONE
clone_end	ZMAPSTYLE_MODE_BASIC	ZMAPHOMOL_NONE
point_centromere	ZMAPSTYLE_MODE_BASIC	ZMAPHOMOL_NONE
regional_centromere	ZMAPSTYLE_MODE_BASIC	ZMAPHOMOL_NONE
regional_centromere_central_core	ZMAPSTYLE_MODE_BASIC	ZMAPHOMOL_NONE
centromeric_repeat	ZMAPSTYLE_MODE_BASIC	ZMAPHOMOL_NONE
regional_centromere_inner_repeat_region	ZMAPSTYLE_MODE_BASIC	ZMAPHOMOL_NONE
regional_centromere_outer_repeat_region	ZMAPSTYLE_MODE_BASIC	ZMAPHOMOL_NONE
tasiRNA	ZMAPSTYLE_MODE_BASIC	ZMAPHOMOL_NONE
tasiRNA_primary_transcript	ZMAPSTYLE_MODE_TRANSCRIPT	ZMAPHOMOL_NONE
increased_polyadenylation_variant	ZMAPSTYLE_MODE_BASIC	ZMAPHOMOL_NONE
decreased_polyadenylation_variant	ZMAPSTYLE_MODE_BASIC	ZMAPHOMOL_NONE
DDB_box	ZMAPSTYLE_MODE_BASIC	ZMAPHOMOL_NONE
destruction_box	ZMAPSTYLE_MODE_BASIC	ZMAPHOMOL_NONE
ER_retention_signal	ZMAPSTYLE_MODE_BASIC	ZMAPHOMOL_NONE
KEN_box	ZMAPSTYLE_MODE_BASIC	ZMAPHOMOL_NONE
mitochondrial_targeting_signal	ZMAPSTYLE_MODE_BASIC	ZMAPHOMOL_NONE
signal_anchor	ZMAPSTYLE_MODE_BASIC	ZMAPHOMOL_NONE
PIP_box	ZMAPSTYLE_MODE_BASIC	ZMAPHOMOL_NONE
phosphorylation_site	ZMAPSTYLE_MODE_BASIC	ZMAPHOMOL_NONE
transmembrane_helix	ZMAPSTYLE_MODE_BASIC	ZMAPHOMOL_NONE
vacuolar_sorting_signal	ZMAPSTYLE_MODE_BASIC	ZMAPHOMOL_NONE
coding_variant_quality	ZMAPSTYLE_MODE_BASIC	ZMAPHOMOL_NONE
synonymous	ZMAPSTYLE_MODE_BASIC	ZMAPHOMOL_NONE
non_synonymous	ZMAPSTYLE_MODE_BASIC	ZMAPHOMOL_NONE
inframe	ZMAPSTYLE_MODE_BASIC	ZMAPHOMOL_NONE
protein_altering_variant	ZMAPSTYLE_MODE_BASIC	ZMAPHOMOL_NONE
synonymous_variant	ZMAPSTYLE_MODE_BASIC	ZMAPHOMOL_NONE
inframe_indel	ZMAPSTYLE_MODE_BASIC	ZMAPHOMOL_NONE
inframe_insertion	ZMAPSTYLE_MODE_BASIC	ZMAPHOMOL_NONE
inframe_deletion	ZMAPSTYLE_MODE_BASIC	ZMAPHOMOL_NONE
conservative_inframe_insertion	ZMAPSTYLE_MODE_BASIC	ZMAPHOMOL_NONE
disruptive_inframe_insertion	ZMAPSTYLE_MODE_BASIC	ZMAPHOMOL_NONE
conservative_inframe_deletion	ZMAPSTYLE_MODE_BASIC	ZMAPHOMOL_NONE
disruptive_inframe_deletion	ZMAPSTYLE_MODE_BASIC	ZMAPHOMOL_NONE
mRNA_read	ZMAPSTYLE_MODE_BASIC	ZMAPHOMOL_NONE
genomic_DNA_read	ZMAPSTYLE_MODE_BASIC	ZMAPHOMOL_NONE
mRNA_contig	ZMAPSTYLE_MODE_BASIC	ZMAPHOMOL_NONE
AFLP_fragment	ZMAPSTYLE_MODE_BASIC	ZMAPHOMOL_NONE
protein_hmm_match	ZMAPSTYLE_MODE_ALIGNMENT	ZMAPHOMOL_NONE
immunoglobulin_region	ZMAPSTYLE_MODE_BASIC	ZMAPHOMOL_NONE
V_region	ZMAPSTYLE_MODE_BASIC	ZMAPHOMOL_NONE
C_region	ZMAPSTYLE_MODE_BASIC	ZMAPHOMOL_NONE
N_region	ZMAPSTYLE_MODE_BASIC	ZMAPHOMOL_NONE
S_region	ZMAPSTYLE_MODE_BASIC	ZMAPHOMOL_NONE
mobile_element_insertion	ZMAPSTYLE_MODE_BASIC	ZMAPHOMOL_NONE
novel_sequence_insertion	ZMAPSTYLE_MODE_BASIC	ZMAPHOMOL_NONE
CSL_response_element	ZMAPSTYLE_MODE_BASIC	ZMAPHOMOL_NONE
GATA_box	ZMAPSTYLE_MODE_BASIC	ZMAPHOMOL_NONE
polymorphic_pseudogene	ZMAPSTYLE_MODE_BASIC	ZMAPHOMOL_NONE
AP_1_binding_site	ZMAPSTYLE_MODE_BASIC	ZMAPHOMOL_NONE
CRE	ZMAPSTYLE_MODE_BASIC	ZMAPHOMOL_NONE
CuRE	ZMAPSTYLE_MODE_BASIC	ZMAPHOMOL_NONE
DRE	ZMAPSTYLE_MODE_BASIC	ZMAPHOMOL_NONE
FLEX_element	ZMAPSTYLE_MODE_BASIC	ZMAPHOMOL_NONE
forkhead_motif	ZMAPSTYLE_MODE_BASIC	ZMAPHOMOL_NONE
homol_D_box	ZMAPSTYLE_MODE_BASIC	ZMAPHOMOL_NONE
homol_E_box	ZMAPSTYLE_MODE_BASIC	ZMAPHOMOL_NONE
HSE	ZMAPSTYLE_MODE_BASIC	ZMAPHOMOL_NONE
iron_repressed_GATA_element	ZMAPSTYLE_MODE_BASIC	ZMAPHOMOL_NONE
mating_type_M_box	ZMAPSTYLE_MODE_BASIC	ZMAPHOMOL_NONE
androgen_response_element	ZMAPSTYLE_MODE_BASIC	ZMAPHOMOL_NONE
smFISH_probe	ZMAPSTYLE_MODE_BASIC	ZMAPHOMOL_NONE
MCB	ZMAPSTYLE_MODE_BASIC	ZMAPHOMOL_NONE
CCAAT_motif	ZMAPSTYLE_MODE_BASIC	ZMAPHOMOL_NONE
Ace2_UAS	ZMAPSTYLE_MODE_BASIC	ZMAPHOMOL_NONE
TR_box	ZMAPSTYLE_MODE_BASIC	ZMAPHOMOL_NONE
STREP_motif	ZMAPSTYLE_MODE_BASIC	ZMAPHOMOL_NONE
rDNA_intergenic_spacer_element	ZMAPSTYLE_MODE_BASIC	ZMAPHOMOL_NONE
sterol_regulatory_element	ZMAPSTYLE_MODE_BASIC	ZMAPHOMOL_NONE
GT_dinucleotide_repeat	ZMAPSTYLE_MODE_BASIC	ZMAPHOMOL_NONE
GTT_trinucleotide_repeat	ZMAPSTYLE_MODE_BASIC	ZMAPHOMOL_NONE
Sap1_recognition_motif	ZMAPSTYLE_MODE_BASIC	ZMAPHOMOL_NONE
CDRE_motif	ZMAPSTYLE_MODE_BASIC	ZMAPHOMOL_NONE
BAC_read_contig	ZMAPSTYLE_MODE_BASIC	ZMAPHOMOL_NONE
candidate_gene	ZMAPSTYLE_MODE_BASIC	ZMAPHOMOL_NONE
positional_candidate_gene	ZMAPSTYLE_MODE_BASIC	ZMAPHOMOL_NONE
functional_candidate_gene	ZMAPSTYLE_MODE_BASIC	ZMAPHOMOL_NONE
enhancerRNA	ZMAPSTYLE_MODE_BASIC	ZMAPHOMOL_NONE
PCB	ZMAPSTYLE_MODE_BASIC	ZMAPHOMOL_NONE
rearrangement_breakpoint	ZMAPSTYLE_MODE_BASIC	ZMAPHOMOL_NONE
interchromosomal_breakpoint	ZMAPSTYLE_MODE_BASIC	ZMAPHOMOL_NONE
intrachromosomal_breakpoint	ZMAPSTYLE_MODE_BASIC	ZMAPHOMOL_NONE
unassigned_supercontig	ZMAPSTYLE_MODE_BASIC	ZMAPHOMOL_NONE
partial_genomic_sequence_assembly	ZMAPSTYLE_MODE_BASIC	ZMAPHOMOL_NONE
lnc_RNA	ZMAPSTYLE_MODE_BASIC	ZMAPHOMOL_NONE
feature_variant	ZMAPSTYLE_MODE_BASIC	ZMAPHOMOL_NONE
feature_ablation	ZMAPSTYLE_MODE_BASIC	ZMAPHOMOL_NONE
feature_amplification	ZMAPSTYLE_MODE_BASIC	ZMAPHOMOL_NONE
feature_translocation	ZMAPSTYLE_MODE_BASIC	ZMAPHOMOL_NONE
feature_fusion	ZMAPSTYLE_MODE_BASIC	ZMAPHOMOL_NONE
transcript_translocation	ZMAPSTYLE_MODE_BASIC	ZMAPHOMOL_NONE
regulatory_region_translocation	ZMAPSTYLE_MODE_BASIC	ZMAPHOMOL_NONE
TFBS_translocation	ZMAPSTYLE_MODE_BASIC	ZMAPHOMOL_NONE
transcript_fusion	ZMAPSTYLE_MODE_BASIC	ZMAPHOMOL_NONE
regulatory_region_fusion	ZMAPSTYLE_MODE_BASIC	ZMAPHOMOL_NONE
TFBS_fusion	ZMAPSTYLE_MODE_BASIC	ZMAPHOMOL_NONE
transcript_amplification	ZMAPSTYLE_MODE_BASIC	ZMAPHOMOL_NONE
transcript_regulatory_region_fusion	ZMAPSTYLE_MODE_BASIC	ZMAPHOMOL_NONE
regulatory_region_amplification	ZMAPSTYLE_MODE_BASIC	ZMAPHOMOL_NONE
TFBS_amplification	ZMAPSTYLE_MODE_BASIC	ZMAPHOMOL_NONE
transcript_ablation	ZMAPSTYLE_MODE_BASIC	ZMAPHOMOL_NONE
regulatory_region_ablation	ZMAPSTYLE_MODE_BASIC	ZMAPHOMOL_NONE
TFBS_ablation	ZMAPSTYLE_MODE_BASIC	ZMAPHOMOL_NONE
transposable_element_CDS	ZMAPSTYLE_MODE_BASIC	ZMAPHOMOL_NONE
transposable_element_pseudogene	ZMAPSTYLE_MODE_BASIC	ZMAPHOMOL_NONE
dg_repeat	ZMAPSTYLE_MODE_BASIC	ZMAPHOMOL_NONE
dh_repeat	ZMAPSTYLE_MODE_BASIC	ZMAPHOMOL_NONE
M26_binding_site	ZMAPSTYLE_MODE_BASIC	ZMAPHOMOL_NONE
AACCCT_box	ZMAPSTYLE_MODE_BASIC	ZMAPHOMOL_NONE
splice_region	ZMAPSTYLE_MODE_BASIC	ZMAPHOMOL_NONE
intronic_lncRNA	ZMAPSTYLE_MODE_BASIC	ZMAPHOMOL_NONE
antisense_lncRNA	ZMAPSTYLE_MODE_BASIC	ZMAPHOMOL_NONE
regional_centromere_outer_repeat_transcript	ZMAPSTYLE_MODE_TRANSCRIPT	ZMAPHOMOL_NONE
feature_truncation	ZMAPSTYLE_MODE_BASIC	ZMAPHOMOL_NONE
feature_elongation	ZMAPSTYLE_MODE_BASIC	ZMAPHOMOL_NONE
internal_feature_elongation	ZMAPSTYLE_MODE_BASIC	ZMAPHOMOL_NONE
frameshift_elongation	ZMAPSTYLE_MODE_BASIC	ZMAPHOMOL_NONE
frameshift_truncation	ZMAPSTYLE_MODE_BASIC	ZMAPHOMOL_NONE
copy_number_increase	ZMAPSTYLE_MODE_BASIC	ZMAPHOMOL_NONE
copy_number_decrease	ZMAPSTYLE_MODE_BASIC	ZMAPHOMOL_NONE
bacterial_RNApol_promoter_sigma_ecf	ZMAPSTYLE_MODE_BASIC	ZMAPHOMOL_NONE
rDNA_replication_fork_barrier	ZMAPSTYLE_MODE_BASIC	ZMAPHOMOL_NONE
transcription_start_cluster	ZMAPSTYLE_MODE_BASIC	ZMAPHOMOL_NONE
CAGE_tag	ZMAPSTYLE_MODE_BASIC	ZMAPHOMOL_NONE
CAGE_cluster	ZMAPSTYLE_MODE_BASIC	ZMAPHOMOL_NONE
5_methylcytosine	ZMAPSTYLE_MODE_BASIC	ZMAPHOMOL_NONE
4_methylcytosine	ZMAPSTYLE_MODE_BASIC	ZMAPHOMOL_NONE
N6_methyladenine	ZMAPSTYLE_MODE_BASIC	ZMAPHOMOL_NONE
mitochondrial_contig	ZMAPSTYLE_MODE_BASIC	ZMAPHOMOL_NONE
mitochondrial_supercontig	ZMAPSTYLE_MODE_BASIC	ZMAPHOMOL_NONE
TERRA	ZMAPSTYLE_MODE_BASIC	ZMAPHOMOL_NONE
ARRET	ZMAPSTYLE_MODE_BASIC	ZMAPHOMOL_NONE
ARIA	ZMAPSTYLE_MODE_BASIC	ZMAPHOMOL_NONE
anti_ARRET	ZMAPSTYLE_MODE_BASIC	ZMAPHOMOL_NONE
telomeric_transcript	ZMAPSTYLE_MODE_TRANSCRIPT	ZMAPHOMOL_NONE
distal_duplication	ZMAPSTYLE_MODE_BASIC	ZMAPHOMOL_NONE
mitochondrial_DNA_read	ZMAPSTYLE_MODE_BASIC	ZMAPHOMOL_NONE
chloroplast_DNA_read	ZMAPSTYLE_MODE_BASIC	ZMAPHOMOL_NONE
consensus_gDNA	ZMAPSTYLE_MODE_BASIC	ZMAPHOMOL_NONE
restriction_enzyme_five_prime_single_strand_overhang	ZMAPSTYLE_MODE_BASIC	ZMAPHOMOL_NONE
restriction_enzyme_three_prime_single_strand_overhang	ZMAPSTYLE_MODE_BASIC	ZMAPHOMOL_NONE
monomeric_repeat	ZMAPSTYLE_MODE_BASIC	ZMAPHOMOL_NONE
H3K20_trimethylation_site	ZMAPSTYLE_MODE_BASIC	ZMAPHOMOL_NONE
H3K36_acetylation_site	ZMAPSTYLE_MODE_BASIC	ZMAPHOMOL_NONE
H2BK12_acetylation_site	ZMAPSTYLE_MODE_BASIC	ZMAPHOMOL_NONE
H2AK5_acetylation_site	ZMAPSTYLE_MODE_BASIC	ZMAPHOMOL_NONE
H4K12_acetylation_site	ZMAPSTYLE_MODE_BASIC	ZMAPHOMOL_NONE
H2BK120_acetylation_site	ZMAPSTYLE_MODE_BASIC	ZMAPHOMOL_NONE
H4K91_acetylation_site	ZMAPSTYLE_MODE_BASIC	ZMAPHOMOL_NONE
H2BK20_acetylation_site	ZMAPSTYLE_MODE_BASIC	ZMAPHOMOL_NONE
H3K4ac_acetylation_site	ZMAPSTYLE_MODE_BASIC	ZMAPHOMOL_NONE
H2AK9_acetylation_site	ZMAPSTYLE_MODE_BASIC	ZMAPHOMOL_NONE
H3K56_acetylation_site	ZMAPSTYLE_MODE_BASIC	ZMAPHOMOL_NONE
H2BK15_acetylation_site	ZMAPSTYLE_MODE_BASIC	ZMAPHOMOL_NONE
H3R2_monomethylation_site	ZMAPSTYLE_MODE_BASIC	ZMAPHOMOL_NONE
H3R2_dimethylation_site	ZMAPSTYLE_MODE_BASIC	ZMAPHOMOL_NONE
H4R3_dimethylation_site	ZMAPSTYLE_MODE_BASIC	ZMAPHOMOL_NONE
H4K4_trimethylation_site	ZMAPSTYLE_MODE_BASIC	ZMAPHOMOL_NONE
H3K23_dimethylation_site	ZMAPSTYLE_MODE_BASIC	ZMAPHOMOL_NONE
promoter_flanking_region	ZMAPSTYLE_MODE_BASIC	ZMAPHOMOL_NONE
restriction_enzyme_assembly_scar	ZMAPSTYLE_MODE_BASIC	ZMAPHOMOL_NONE
restriction_enzyme_region	ZMAPSTYLE_MODE_BASIC	ZMAPHOMOL_NONE
protein_stability_element	ZMAPSTYLE_MODE_BASIC	ZMAPHOMOL_NONE
protease_site	ZMAPSTYLE_MODE_BASIC	ZMAPHOMOL_NONE
lariat_intron	ZMAPSTYLE_MODE_BASIC	ZMAPHOMOL_NONE
TCT_motif	ZMAPSTYLE_MODE_BASIC	ZMAPHOMOL_NONE
5_hydroxymethylcytosine	ZMAPSTYLE_MODE_BASIC	ZMAPHOMOL_NONE
5_formylcytosine	ZMAPSTYLE_MODE_BASIC	ZMAPHOMOL_NONE
modified_adenine	ZMAPSTYLE_MODE_BASIC	ZMAPHOMOL_NONE
modified_cytosine	ZMAPSTYLE_MODE_BASIC	ZMAPHOMOL_NONE
modified_guanine	ZMAPSTYLE_MODE_BASIC	ZMAPHOMOL_NONE
8_oxoguanine	ZMAPSTYLE_MODE_BASIC	ZMAPHOMOL_NONE
5_carboxylcytosine	ZMAPSTYLE_MODE_BASIC	ZMAPHOMOL_NONE
8_oxoadenine	ZMAPSTYLE_MODE_BASIC	ZMAPHOMOL_NONE
coding_transcript_variant	ZMAPSTYLE_MODE_TRANSCRIPT	ZMAPHOMOL_NONE
coding_transcript_intron_variant	ZMAPSTYLE_MODE_TRANSCRIPT	ZMAPHOMOL_NONE
non_coding_transcript_intron_variant	ZMAPSTYLE_MODE_TRANSCRIPT	ZMAPHOMOL_NONE
zinc_finger_binding_site	ZMAPSTYLE_MODE_BASIC	ZMAPHOMOL_NONE
histone_4_acylation_site	ZMAPSTYLE_MODE_BASIC	ZMAPHOMOL_NONE
histone_3_acetylation_site	ZMAPSTYLE_MODE_BASIC	ZMAPHOMOL_NONE
CTCF_binding_site	ZMAPSTYLE_MODE_BASIC	ZMAPHOMOL_NONE
five_prime_sticky_end_restriction_enzyme_cleavage_site	ZMAPSTYLE_MODE_BASIC	ZMAPHOMOL_NONE
three_prime_sticky_end_restriction_enzyme_cleavage_site	ZMAPSTYLE_MODE_BASIC	ZMAPHOMOL_NONE
ribonuclease_site	ZMAPSTYLE_MODE_BASIC	ZMAPHOMOL_NONE
signature	ZMAPSTYLE_MODE_BASIC	ZMAPHOMOL_NONE
RNA_stability_element	ZMAPSTYLE_MODE_BASIC	ZMAPHOMOL_NONE
G_box	ZMAPSTYLE_MODE_BASIC	ZMAPHOMOL_NONE
L_box	ZMAPSTYLE_MODE_BASIC	ZMAPHOMOL_NONE
box	ZMAPSTYLE_MODE_BASIC	ZMAPHOMOL_NONE
5_prime_UTR_premature_start_codon_variant	ZMAPSTYLE_MODE_BASIC	ZMAPHOMOL_NONE
silent_mating_type_cassette_array	ZMAPSTYLE_MODE_BASIC	ZMAPHOMOL_NONE
Okazaki_fragment	ZMAPSTYLE_MODE_BASIC	ZMAPHOMOL_NONE
upstream_transcript_variant	ZMAPSTYLE_MODE_TRANSCRIPT	ZMAPHOMOL_NONE
downstream_transcript_variant	ZMAPSTYLE_MODE_TRANSCRIPT	ZMAPHOMOL_NONE
5_prime_UTR_premature_start_codon_gain_variant	ZMAPSTYLE_MODE_BASIC	ZMAPHOMOL_NONE
5_prime_UTR_premature_start_codon_loss_variant	ZMAPSTYLE_MODE_BASIC	ZMAPHOMOL_NONE
five_prime_UTR_premature_start_codon_location_variant	ZMAPSTYLE_MODE_BASIC	ZMAPHOMOL_NONE
consensus_AFLP_fragment	ZMAPSTYLE_MODE_BASIC	ZMAPHOMOL_NONE
nonsynonymous_variant	ZMAPSTYLE_MODE_BASIC	ZMAPHOMOL_NONE
regulatory_region	ZMAPSTYLE_MODE_BASIC	ZMAPHOMOL_NONE
U14_snoRNA_primary_transcript	ZMAPSTYLE_MODE_TRANSCRIPT	ZMAPHOMOL_NONE
methylation_guide_snoRNA	ZMAPSTYLE_MODE_BASIC	ZMAPHOMOL_NONE
rRNA_cleavage_RNA	ZMAPSTYLE_MODE_BASIC	ZMAPHOMOL_NONE
exon_of_single_exon_gene	ZMAPSTYLE_MODE_BASIC	ZMAPHOMOL_NONE
cassette_array_member	ZMAPSTYLE_MODE_BASIC	ZMAPHOMOL_NONE
gene_cassette_member	ZMAPSTYLE_MODE_BASIC	ZMAPHOMOL_NONE
gene_subarray_member	ZMAPSTYLE_MODE_BASIC	ZMAPHOMOL_NONE
primer_binding_site	ZMAPSTYLE_MODE_BASIC	ZMAPHOMOL_NONE
gene_array	ZMAPSTYLE_MODE_BASIC	ZMAPHOMOL_NONE
gene_subarray	ZMAPSTYLE_MODE_BASIC	ZMAPHOMOL_NONE
gene_cassette	ZMAPSTYLE_MODE_BASIC	ZMAPHOMOL_NONE
gene_cassette_array	ZMAPSTYLE_MODE_BASIC	ZMAPHOMOL_NONE
gene_group	ZMAPSTYLE_MODE_BASIC	ZMAPHOMOL_NONE
selenocysteine_tRNA_primary_transcript	ZMAPSTYLE_MODE_TRANSCRIPT	ZMAPHOMOL_NONE
selenocysteinyl_tRNA	ZMAPSTYLE_MODE_BASIC	ZMAPHOMOL_NONE
syntenic_region	ZMAPSTYLE_MODE_BASIC	ZMAPHOMOL_NONE
biochemical_region_of_peptide	ZMAPSTYLE_MODE_BASIC	ZMAPHOMOL_NONE
molecular_contact_region	ZMAPSTYLE_MODE_BASIC	ZMAPHOMOL_NONE
intrinsically_unstructured_polypeptide_region	ZMAPSTYLE_MODE_BASIC	ZMAPHOMOL_NONE
catmat_left_handed_three	ZMAPSTYLE_MODE_BASIC	ZMAPHOMOL_NONE
catmat_left_handed_four	ZMAPSTYLE_MODE_BASIC	ZMAPHOMOL_NONE
catmat_right_handed_three	ZMAPSTYLE_MODE_BASIC	ZMAPHOMOL_NONE
catmat_right_handed_four	ZMAPSTYLE_MODE_BASIC	ZMAPHOMOL_NONE
alpha_beta_motif	ZMAPSTYLE_MODE_BASIC	ZMAPHOMOL_NONE
lipoprotein_signal_peptide	ZMAPSTYLE_MODE_BASIC	ZMAPHOMOL_NONE
no_output	ZMAPSTYLE_MODE_BASIC	ZMAPHOMOL_NONE
cleaved_peptide_region	ZMAPSTYLE_MODE_BASIC	ZMAPHOMOL_NONE
peptide_coil	ZMAPSTYLE_MODE_BASIC	ZMAPHOMOL_NONE
hydrophobic_region_of_peptide	ZMAPSTYLE_MODE_BASIC	ZMAPHOMOL_NONE
n_terminal_region	ZMAPSTYLE_MODE_BASIC	ZMAPHOMOL_NONE
c_terminal_region	ZMAPSTYLE_MODE_BASIC	ZMAPHOMOL_NONE
central_hydrophobic_region_of_signal_peptide	ZMAPSTYLE_MODE_BASIC	ZMAPHOMOL_NONE
polypeptide_conserved_motif	ZMAPSTYLE_MODE_BASIC	ZMAPHOMOL_NONE
polypeptide_binding_motif	ZMAPSTYLE_MODE_BASIC	ZMAPHOMOL_NONE
polypeptide_catalytic_motif	ZMAPSTYLE_MODE_BASIC	ZMAPHOMOL_NONE
polypeptide_DNA_contact	ZMAPSTYLE_MODE_BASIC	ZMAPHOMOL_NONE
polypeptide_conserved_region	ZMAPSTYLE_MODE_BASIC	ZMAPHOMOL_NONE
substitution	ZMAPSTYLE_MODE_BASIC	ZMAPHOMOL_NONE
complex_substitution	ZMAPSTYLE_MODE_BASIC	ZMAPHOMOL_NONE
point_mutation	ZMAPSTYLE_MODE_BASIC	ZMAPHOMOL_NONE
transition	ZMAPSTYLE_MODE_BASIC	ZMAPHOMOL_NONE
pyrimidine_transition	ZMAPSTYLE_MODE_BASIC	ZMAPHOMOL_NONE
C_to_T_transition	ZMAPSTYLE_MODE_BASIC	ZMAPHOMOL_NONE
C_to_T_transition_at_pCpG_site	ZMAPSTYLE_MODE_BASIC	ZMAPHOMOL_NONE
T_to_C_transition	ZMAPSTYLE_MODE_BASIC	ZMAPHOMOL_NONE
purine_transition	ZMAPSTYLE_MODE_BASIC	ZMAPHOMOL_NONE
A_to_G_transition	ZMAPSTYLE_MODE_BASIC	ZMAPHOMOL_NONE
G_to_A_transition	ZMAPSTYLE_MODE_BASIC	ZMAPHOMOL_NONE
transversion	ZMAPSTYLE_MODE_BASIC	ZMAPHOMOL_NONE
pyrimidine_to_purine_transversion	ZMAPSTYLE_MODE_BASIC	ZMAPHOMOL_NONE
C_to_A_transversion	ZMAPSTYLE_MODE_BASIC	ZMAPHOMOL_NONE
C_to_G_transversion	ZMAPSTYLE_MODE_BASIC	ZMAPHOMOL_NONE
T_to_A_transversion	ZMAPSTYLE_MODE_BASIC	ZMAPHOMOL_NONE
T_to_G_transversion	ZMAPSTYLE_MODE_BASIC	ZMAPHOMOL_NONE
purine_to_pyrimidine_transversion	ZMAPSTYLE_MODE_BASIC	ZMAPHOMOL_NONE
A_to_C_transversion	ZMAPSTYLE_MODE_BASIC	ZMAPHOMOL_NONE
A_to_T_transversion	ZMAPSTYLE_MODE_BASIC	ZMAPHOMOL_NONE
G_to_C_transversion	ZMAPSTYLE_MODE_BASIC	ZMAPHOMOL_NONE
G_to_T_transversion	ZMAPSTYLE_MODE_BASIC	ZMAPHOMOL_NONE
intrachromosomal_mutation	ZMAPSTYLE_MODE_BASIC	ZMAPHOMOL_NONE
chromosomal_deletion	ZMAPSTYLE_MODE_BASIC	ZMAPHOMOL_NONE
chromosomal_inversion	ZMAPSTYLE_MODE_BASIC	ZMAPHOMOL_NONE
interchromosomal_mutation	ZMAPSTYLE_MODE_BASIC	ZMAPHOMOL_NONE
indel	ZMAPSTYLE_MODE_BASIC	ZMAPHOMOL_NONE
duplication	ZMAPSTYLE_MODE_BASIC	ZMAPHOMOL_NONE
inversion	ZMAPSTYLE_MODE_BASIC	ZMAPHOMOL_NONE
chromosomal_duplication	ZMAPSTYLE_MODE_BASIC	ZMAPHOMOL_NONE
intrachromosomal_duplication	ZMAPSTYLE_MODE_BASIC	ZMAPHOMOL_NONE
direct_tandem_duplication	ZMAPSTYLE_MODE_BASIC	ZMAPHOMOL_NONE
inverted_tandem_duplication	ZMAPSTYLE_MODE_BASIC	ZMAPHOMOL_NONE
intrachromosomal_transposition	ZMAPSTYLE_MODE_BASIC	ZMAPHOMOL_NONE
compound_chromosome	ZMAPSTYLE_MODE_BASIC	ZMAPHOMOL_NONE
Robertsonian_fusion	ZMAPSTYLE_MODE_BASIC	ZMAPHOMOL_NONE
chromosomal_translocation	ZMAPSTYLE_MODE_BASIC	ZMAPHOMOL_NONE
ring_chromosome	ZMAPSTYLE_MODE_BASIC	ZMAPHOMOL_NONE
pericentric_inversion	ZMAPSTYLE_MODE_BASIC	ZMAPHOMOL_NONE
paracentric_inversion	ZMAPSTYLE_MODE_BASIC	ZMAPHOMOL_NONE
reciprocal_chromosomal_translocation	ZMAPSTYLE_MODE_BASIC	ZMAPHOMOL_NONE
autosynaptic_chromosome	ZMAPSTYLE_MODE_BASIC	ZMAPHOMOL_NONE
homo_compound_chromosome	ZMAPSTYLE_MODE_BASIC	ZMAPHOMOL_NONE
hetero_compound_chromosome	ZMAPSTYLE_MODE_BASIC	ZMAPHOMOL_NONE
chromosome_fission	ZMAPSTYLE_MODE_BASIC	ZMAPHOMOL_NONE
dexstrosynaptic_chromosome	ZMAPSTYLE_MODE_BASIC	ZMAPHOMOL_NONE
laevosynaptic_chromosome	ZMAPSTYLE_MODE_BASIC	ZMAPHOMOL_NONE
free_duplication	ZMAPSTYLE_MODE_BASIC	ZMAPHOMOL_NONE
free_ring_duplication	ZMAPSTYLE_MODE_BASIC	ZMAPHOMOL_NONE
complex_chromosomal_mutation	ZMAPSTYLE_MODE_BASIC	ZMAPHOMOL_NONE
deficient_translocation	ZMAPSTYLE_MODE_BASIC	ZMAPHOMOL_NONE
inversion_cum_translocation	ZMAPSTYLE_MODE_BASIC	ZMAPHOMOL_NONE
bipartite_duplication	ZMAPSTYLE_MODE_BASIC	ZMAPHOMOL_NONE
cyclic_translocation	ZMAPSTYLE_MODE_BASIC	ZMAPHOMOL_NONE
bipartite_inversion	ZMAPSTYLE_MODE_BASIC	ZMAPHOMOL_NONE
uninverted_insertional_duplication	ZMAPSTYLE_MODE_BASIC	ZMAPHOMOL_NONE
inverted_insertional_duplication	ZMAPSTYLE_MODE_BASIC	ZMAPHOMOL_NONE
insertional_duplication	ZMAPSTYLE_MODE_BASIC	ZMAPHOMOL_NONE
interchromosomal_transposition	ZMAPSTYLE_MODE_BASIC	ZMAPHOMOL_NONE
inverted_interchromosomal_transposition	ZMAPSTYLE_MODE_BASIC	ZMAPHOMOL_NONE
uninverted_interchromosomal_transposition	ZMAPSTYLE_MODE_BASIC	ZMAPHOMOL_NONE
inverted_intrachromosomal_transposition	ZMAPSTYLE_MODE_BASIC	ZMAPHOMOL_NONE
uninverted_intrachromosomal_transposition	ZMAPSTYLE_MODE_BASIC	ZMAPHOMOL_NONE
unoriented_insertional_duplication	ZMAPSTYLE_MODE_BASIC	ZMAPHOMOL_NONE
unoriented_interchromosomal_transposition	ZMAPSTYLE_MODE_BASIC	ZMAPHOMOL_NONE
unoriented_intrachromosomal_transposition	ZMAPSTYLE_MODE_BASIC	ZMAPHOMOL_NONE
uncharacterised_chromosomal_mutation	ZMAPSTYLE_MODE_BASIC	ZMAPHOMOL_NONE
deficient_inversion	ZMAPSTYLE_MODE_BASIC	ZMAPHOMOL_NONE
tandem_duplication	ZMAPSTYLE_MODE_BASIC	ZMAPHOMOL_NONE
partially_characterised_chromosomal_mutation	ZMAPSTYLE_MODE_BASIC	ZMAPHOMOL_NONE
chromosome_number_variation	ZMAPSTYLE_MODE_BASIC	ZMAPHOMOL_NONE
chromosome_structure_variation	ZMAPSTYLE_MODE_BASIC	ZMAPHOMOL_NONE
alternatively_spliced_transcript	ZMAPSTYLE_MODE_TRANSCRIPT	ZMAPHOMOL_NONE
encodes_1_polypeptide	ZMAPSTYLE_MODE_BASIC	ZMAPHOMOL_NONE
encodes_greater_than_1_polypeptide	ZMAPSTYLE_MODE_BASIC	ZMAPHOMOL_NONE
encodes_different_polypeptides_different_stop	ZMAPSTYLE_MODE_BASIC	ZMAPHOMOL_NONE
encodes_overlapping_peptides_different_start	ZMAPSTYLE_MODE_BASIC	ZMAPHOMOL_NONE
encodes_disjoint_polypeptides	ZMAPSTYLE_MODE_BASIC	ZMAPHOMOL_NONE
encodes_overlapping_polypeptides_different_start_and_stop	ZMAPSTYLE_MODE_BASIC	ZMAPHOMOL_NONE
encodes_overlapping_peptides	ZMAPSTYLE_MODE_BASIC	ZMAPHOMOL_NONE
cryptogene	ZMAPSTYLE_MODE_BASIC	ZMAPHOMOL_NONE
dicistronic_primary_transcript	ZMAPSTYLE_MODE_TRANSCRIPT	ZMAPHOMOL_NONE
member_of_regulon	ZMAPSTYLE_MODE_BASIC	ZMAPHOMOL_NONE
CDS_independently_known	ZMAPSTYLE_MODE_BASIC	ZMAPHOMOL_NONE
orphan_CDS	ZMAPSTYLE_MODE_BASIC	ZMAPHOMOL_NONE
CDS_supported_by_domain_match_data	ZMAPSTYLE_MODE_BASIC	ZMAPHOMOL_NONE
CDS_supported_by_sequence_similarity_data	ZMAPSTYLE_MODE_BASIC	ZMAPHOMOL_NONE
CDS_predicted	ZMAPSTYLE_MODE_BASIC	ZMAPHOMOL_NONE
CDS_supported_by_EST_or_cDNA_data	ZMAPSTYLE_MODE_BASIC	ZMAPHOMOL_NONE
internal_Shine_Dalgarno_sequence	ZMAPSTYLE_MODE_BASIC	ZMAPHOMOL_NONE
recoded_mRNA	ZMAPSTYLE_MODE_BASIC	ZMAPHOMOL_NONE
minus_1_translationally_frameshifted	ZMAPSTYLE_MODE_BASIC	ZMAPHOMOL_NONE
plus_1_translationally_frameshifted	ZMAPSTYLE_MODE_BASIC	ZMAPHOMOL_NONE
mRNA_recoded_by_translational_bypass	ZMAPSTYLE_MODE_BASIC	ZMAPHOMOL_NONE
mRNA_recoded_by_codon_redefinition	ZMAPSTYLE_MODE_BASIC	ZMAPHOMOL_NONE
recoding_stimulatory_region	ZMAPSTYLE_MODE_BASIC	ZMAPHOMOL_NONE
four_bp_start_codon	ZMAPSTYLE_MODE_BASIC	ZMAPHOMOL_NONE
archaeal_intron	ZMAPSTYLE_MODE_BASIC	ZMAPHOMOL_NONE
tRNA_intron	ZMAPSTYLE_MODE_BASIC	ZMAPHOMOL_NONE
CTG_start_codon	ZMAPSTYLE_MODE_BASIC	ZMAPHOMOL_NONE
SECIS_element	ZMAPSTYLE_MODE_BASIC	ZMAPHOMOL_NONE
retron	ZMAPSTYLE_MODE_BASIC	ZMAPHOMOL_NONE
three_prime_recoding_site	ZMAPSTYLE_MODE_BASIC	ZMAPHOMOL_NONE
three_prime_stem_loop_structure	ZMAPSTYLE_MODE_BASIC	ZMAPHOMOL_NONE
five_prime_recoding_site	ZMAPSTYLE_MODE_BASIC	ZMAPHOMOL_NONE
flanking_three_prime_quadruplet_recoding_signal	ZMAPSTYLE_MODE_BASIC	ZMAPHOMOL_NONE
UAG_stop_codon_signal	ZMAPSTYLE_MODE_BASIC	ZMAPHOMOL_NONE
UAA_stop_codon_signal	ZMAPSTYLE_MODE_BASIC	ZMAPHOMOL_NONE
regulon	ZMAPSTYLE_MODE_BASIC	ZMAPHOMOL_NONE
UGA_stop_codon_signal	ZMAPSTYLE_MODE_BASIC	ZMAPHOMOL_NONE
three_prime_repeat_recoding_signal	ZMAPSTYLE_MODE_BASIC	ZMAPHOMOL_NONE
distant_three_prime_recoding_signal	ZMAPSTYLE_MODE_BASIC	ZMAPHOMOL_NONE
stop_codon_signal	ZMAPSTYLE_MODE_BASIC	ZMAPHOMOL_NONE
databank_entry	ZMAPSTYLE_MODE_BASIC	ZMAPHOMOL_NONE
gene_segment	ZMAPSTYLE_MODE_BASIC	ZMAPHOMOL_NONE
